,name,type,state,oricodes,total_shootings,ORI7,ACAD_HRS_ADD,FLD_HRS_ADD,OPBUDGET_2019,FLD_HRS_ST,ACAD_HRS_ST,FLD_HRS_TOT,ACAD_HRS_TOT,POPULATION,shootings_per_100k,budget_per_100k
0,Abbeville County Sheriff's Office,sheriff,SC,SC00100,1,SC00100,0,360,2000000.0,0,480,360,480,25000,4.0,8000000.0
1,Aberdeen Police Department,local_police,WA,WA01401,1,WA01401,0,44,6799803.0,528,720,572,720,16827,5.942829975634397,40410073.0968087
2,Abilene Police Department,local_police,TX,TX22101,3,TX22101,372,560,30362070.0,0,728,560,1100,124407,2.4114398707468228,24405435.38546866
4,Adams County Sheriff's Department,sheriff,CO,CO00100,12,CO00100,110,0,32120833.0,24,746,24,856,97633,12.290926223715342,32899565.72060676
6,Aiken County Sheriff's Office,sheriff,SC,SC00200,6,SC00200,0,0,15917850.0,480,480,480,480,172295,3.482399373168113,9238718.477030674
7,Akron Police Department,local_police,OH,OH07701,8,OH07701,200,680,56670000.0,0,740,680,940,195994,4.081757604824637,28914150.433176525
9,Alachua County Sheriff's Office,sheriff,FL,FL00100,4,FL00100,0,823,87361604.0,0,770,823,770,118969,3.362220410359001,73432242.01262514
10,Alamance County Sheriff's Office,sheriff,NC,NC00100,2,NC00100,0,686,25952428.0,0,640,686,640,65316,3.062036866923878,39733645.661093764
11,Alameda County Sheriff's Office,sheriff,CA,CA00100,4,CA00100,400,480,222247928.0,40,664,520,1064,253692,1.5767150718193716,87605414.43955663
12,Alamogordo Police Department,local_police,NM,NM01901,2,NM01901,0,0,7624130.0,368,697,368,697,32126,6.225487144369047,23731961.650999192
15,Albemarle County Police Department,local_police,VA,VA00203,1,VA00203,0,240,18000000.0,480,800,720,800,110065,0.9085540362513062,16353972.65252351
17,Albuquerque Police Department,local_police,NM,NM00101,40,NM00101,512,680,188000000.0,0,677,680,1189,562540,7.110605468055605,33419845.699861344
18,Alexandria Police Department,local_police,LA,LA04001,1,LA04001,154,756,18917000.0,0,496,756,650,45573,2.1942817018848877,41509226.95455642
19,Alexandria Police Department,local_police,VA,VA09900,2,VA09900,0,500,67793778.0,100,480,600,480,158726,1.260033012864937,42711199.17341834
21,Allentown Police Department,local_police,PA,PA03901,4,PA03901,8,0,38670975.0,640,919,640,927,121470,3.2929941549353754,31835823.660163008
22,Amarillo Police Department,local_police,TX,TX18801,16,TX18801,488,560,43953657.0,0,696,560,1184,199654,8.01386398469352,22014914.301742014
23,Amherst County Sheriff's Office,sheriff,VA,VA00500,1,VA00500,0,60,3926379.0,100,930,160,930,31526,3.171985028230667,12454415.403159298
24,Anaheim Police Department,local_police,CA,CA03001,14,CA03001,320,320,153803336.0,600,664,920,984,353676,3.958425225347493,43487071.78321401
26,Anderson County Sheriff's Office,sheriff,SC,SC00400,7,SC00400,0,0,18204260.0,320,480,320,480,207090,3.3801728716982953,8790506.543048916
27,Anderson Police Department,local_police,IN,IN04802,1,IN04802,0,0,11965351.0,600,600,600,600,54631,1.8304625578883784,21902126.99749227
28,Angola Police Department,local_police,IN,IN07601,1,IN07601,0,504,2429900.0,0,600,504,600,8827,11.328877308258752,27528038.97133794
29,Ankeny Police Department,local_police,IA,IA07701,1,IA07701,0,170,8496360.0,540,633,710,633,70068,1.4271850202660274,12125877.718787463
30,Anne Arundel County Police Department,local_police,MD,MD00202,7,MD00202,515,240,151162000.0,240,785,480,1300,543253,1.2885340716019977,27825341.04735731
31,Anoka County Sheriff's Office,sheriff,MN,MN00200,1,MN00200,0,504,38578310.0,0,100,504,100,75000,1.3333333333333333,51437746.666666664
32,Anson County Sheriff's Department,sheriff,NC,NC00400,4,NC00400,0,240,5000000.0,0,640,240,640,25275,15.825914935707223,19782393.66963403
33,Ansonia Police Department,local_police,CT,CT00002,1,CT00002,0,0,6637768.0,400,1340,400,1340,18525,5.398110661268556,35831406.20782726
34,Antioch Police Department,local_police,CA,CA00701,4,CA00701,376,0,39868196.0,400,664,400,1040,111605,3.584068814121231,35722589.489718206
35,Appleton Police Department,local_police,WI,WI04501,4,WI04501,0,520,17948165.0,0,720,520,720,74058,5.401172054335791,24235281.806151934
36,Arab Police Department,local_police,AL,AL05003,1,AL05003,12,0,2700000.0,400,560,400,572,8406,11.896264572924103,32119914.346895076
37,Arapahoe County Sheriff's Office,sheriff,CO,CO00300,10,CO00300,280,560,100150784.0,0,548,560,828,650000,1.5384615384615385,15407812.923076924
39,Arlington County Police Department,local_police,VA,VA00701,2,VA00701,320,530,72068068.0,100,480,630,800,240119,0.8329203436629338,30013479.98284184
40,Arlington Police Department,local_police,TX,TX22001,13,TX22001,544,760,112956223.0,0,696,760,1240,398864,3.2592562878575153,28319483.081952743
41,Aroostook County Sheriff's Office,sheriff,ME,ME00200,3,ME00200,0,0,6278699.0,0,720,0,720,28750,10.434782608695652,21838953.04347826
42,Arvada Police Department,local_police,CO,CO03001,10,CO03001,80,800,38534561.0,24,640,824,720,121936,8.201023487731268,31602283.98504133
43,Ashburn Police Department,local_police,GA,GA14201,1,GA14201,60,60,1500000.0,60,480,120,540,3653,27.37476047084588,41062140.70626882
44,Asheville Police Department,local_police,NC,NC01101,1,NC01101,320,0,29927129.0,240,774,240,1094,92852,1.0769827251970878,32231000.947744798
46,Ashville Police Department,local_police,AL,AL05802,1,AL05802,0,180,373682.0,0,560,180,560,2396,41.736227045075125,15596076.794657763
47,Athens-Clarke Police Department,local_police,GA,GA02901,3,GA02901,160,600,24605832.0,0,408,600,568,126566,2.370304821200006,19441107.406412464
48,Atlanta Police Department,local_police,GA,GAAPD00,22,GAAPD00,446,240,207814301.0,0,408,240,854,512550,4.292264169349332,40545176.27548532
49,Atlantic City Police Department,local_police,NJ,NJ00102,4,NJ00102,0,40,27801450.0,440,952,480,952,37569,10.647076046740663,74001038.08991455
50,Auburn Police Department,local_police,AL,AL04301,1,AL04301,0,768,15432644.0,0,560,768,560,68343,1.4632076437967312,22581162.664793763
52,Augusta Police Department,local_police,ME,ME00601,1,ME00601,40,40,5400000.0,700,720,740,760,18747,5.334186803221849,28804608.737397984
53,Aurora Police Department,local_police,CO,CO00101,21,CO00101,484,600,133217416.0,0,556,600,1040,387377,5.421075593026948,34389603.92589132
55,Aurora Police Department,local_police,MO,MO05501,1,MO05501,0,0,1606548.0,480,700,480,700,7432,13.455328310010765,21616630.785791174
56,Austin Police Department,local_police,TX,TX22701,35,TX22701,269,0,434475745.0,560,696,560,965,995484,3.515877703709954,43644673.84709347
57,Avondale Police Department,local_police,AZ,AZ00701,5,AZ00701,80,0,29926300.0,640,585,640,665,88914,5.623411386283375,33657579.23386643
58,Bakersfield Police Department,local_police,CA,CA01502,28,CA01502,250,280,109350815.0,400,664,680,914,385725,7.259057618769849,28349423.81230151
59,Baldwin County Sheriff's Department,sheriff,AL,AL00500,6,AL00500,0,588,28017120.0,0,560,588,560,218022,2.7520158516113056,12850593.059416024
61,Baltimore County Police Department,local_police,MD,MD00301,23,MD00301,208,80,237613323.0,240,792,320,1000,826017,2.784446324954571,28766154.086417105
62,Baltimore Police Department,local_police,MD,MDBPD00,22,MDBPD00,450,0,536376477.0,240,750,240,1200,586131,3.753427134889641,91511364.69492316
63,Bannock County Sheriff's Department,sheriff,ID,ID00300,1,ID00300,0,0,4503378.0,320,566,320,566,17288,5.784359093012494,26049155.48357242
65,Bartlett Police Department,local_police,TN,TN07906,1,TN07906,0,680,14597978.0,0,480,680,480,59327,1.6855731791595734,24605960.18676151
66,Bartow County Sheriff's Office,sheriff,GA,GA00800,3,GA00800,80,240,26178900.0,240,408,480,488,110458,2.7159644389722795,23700320.4838038
67,Baton Rouge Police Department,local_police,LA,LA01702,7,LA01702,309,640,93530380.0,0,496,640,805,219052,3.1955882621478007,42697797.783174776
68,Battle Creek Police Department,local_police,MI,MI13237,3,MI13237,0,40,18000000.0,800,800,840,800,50799,5.905628063544557,35433768.38126735
70,Bayonne Police Department,local_police,NJ,NJ00901,1,NJ00901,80,260,25592000.0,0,800,260,880,65165,1.5345661014348195,39272615.6679199
71,Baytown Police Department,local_police,TX,TX10101,4,TX10101,240,0,28000000.0,160,700,160,940,77288,5.175447676223993,36228133.73356795
72,Beacon Police Department,local_police,NY,NY01301,1,NY01301,24,320,5231159.0,160,700,480,724,13930,7.178750897343861,37553187.36539842
73,Bean Station Police Department,local_police,TN,TN02903,1,TN02903,40,0,351599.0,0,400,0,440,3134,31.90810465858328,11218857.689853223
74,Beaufort County Sheriff's Department,sheriff,SC,SC00700,1,SC00700,0,800,33378832.0,0,462,800,462,192122,0.5205025973079606,17373768.75110607
75,Beaumont Police Department,local_police,TX,TX12301,5,TX12301,0,800,39061900.0,40,712,840,712,115473,4.330016540663185,33827734.62194625
76,Beaverton Police Department,local_police,OR,OR03401,4,OR03401,0,240,33945475.0,50,640,290,640,98957,4.042159725941571,34303257.98073911
79,Bellevue Police Department,local_police,NE,NB07701,1,NB07701,0,720,15556563.0,0,600,720,600,53270,1.8772292096865029,29203234.465928294
80,Bellevue Police Department,local_police,WA,WA01702,1,WA01702,0,801,49030947.0,0,720,801,720,148073,0.6753425675173731,33112685.634788245
81,Bell Gardens Police Department,local_police,CA,CA01909,2,CA01909,340,480,16421422.0,480,664,960,1004,40954,4.883527860526444,40097235.92323094
82,Bellingham Police Department,local_police,WA,WA03701,1,WA03701,0,749,29145597.0,0,720,749,720,93955,1.0643393113724655,31020804.6405194
83,Bell Police Department,local_police,CA,CA01907,1,CA01907,0,0,6984076.0,640,664,640,664,34734,2.879023435250763,20107318.477572408
84,Belton Police Department,local_police,MO,MO01902,3,MO01902,250,408,5649908.0,0,600,408,850,23793,12.608750472828143,23746093.388811834
87,Benton Harbor Department of Public Safety,local_police,MI,MI11248,1,MI11248,80,80,2200000.0,600,900,680,980,9692,10.317787866281469,22699133.305819232
88,Berkeley County Sheriff's Office,sheriff,SC,SC00800,4,SC00800,0,516,5443810.0,0,463,516,463,143382,2.789750456821637,3796717.858587549
89,Bernalillo County Sheriff's Department,sheriff,NM,NM00100,19,NM00100,300,240,60000000.0,0,800,240,1100,150000,12.666666666666666,40000000.0
90,Bexar County Sheriff's Office,sheriff,TX,TX01500,12,TX01500,92,520,150218400.0,140,643,660,735,463885,2.586848033456568,32382681.05241601
91,Bibb County Sheriff's Department,sheriff,GA,GA01100,5,GA01100,0,540,49939378.0,0,408,540,408,153159,3.264581252162785,32606231.43269413
92,Billings Police Department,local_police,MT,MT05601,12,MT05601,0,0,27017423.0,400,480,400,480,109736,10.935335714806445,24620382.554494426
93,Biloxi Police Department,local_police,MS,MS02401,5,MS02401,0,684,18662860.0,0,480,684,480,46127,10.839638389663321,40459730.7433824
94,Birmingham Police Department,local_police,AL,AL00102,10,AL00102,240,640,92775797.0,0,560,640,800,206950,4.832085044696786,44830054.1193525
96,Bismarck Police Department,local_police,ND,ND00801,1,ND00801,0,0,13520138.0,560,480,560,480,74018,1.3510227242022212,18266013.67234997
97,West Dakota Police Department,local_police,ND,ND00801,1,ND00801,0,0,13520138.0,560,480,560,480,74018,1.3510227242022212,18266013.67234997
98,Bloomfield Police Department,local_police,NJ,NJ00702,1,NJ00702,0,308,16581350.0,0,640,308,640,49810,2.007628990162618,33289198.956032924
100,Bloomington Police Department,local_police,MN,MN02701,1,MN02701,240,480,26976602.0,0,900,480,1140,84583,1.1822706690469718,31893645.295153875
102,Blue Springs Police Department,local_police,MO,MO04801,2,MO04801,300,800,11000000.0,0,600,800,900,56547,3.5368808248006083,19452844.536403343
103,Boise Police Department,local_police,ID,ID00101,13,ID00101,850,640,66867208.0,0,100,640,950,229776,5.657684005292111,29101041.013856977
104,Bolingbrook Police Department,local_police,IL,IL09902,1,IL09902,0,24,24557113.0,800,640,824,640,74025,1.3508949679162445,33174080.37825059
105,Bolivar Police Department,local_police,TN,TN03501,1,TN03501,0,0,1740329.0,0,480,0,480,4845,20.63983488132095,35920103.199174404
108,Boone County Sheriff's Office,sheriff,KY,KY00800,1,KY00800,0,0,19509427.0,560,800,560,800,134000,0.7462686567164178,14559273.880597014
109,Boone Police Department,local_police,IA,IA00801,2,IA00801,0,800,1674020.0,0,640,800,640,12407,16.119932296284354,13492544.531312969
110,Bossier City Police Department,local_police,LA,LA00801,1,LA00801,28,0,20866861.0,480,500,480,528,68216,1.465931746217896,30589393.983816113
113,Boulder County Sheriff's Office,sheriff,CO,CO00700,2,CO00700,0,0,51239799.0,160,556,160,556,58000,3.4482758620689657,88344481.03448276
114,Boulder Police Department,local_police,CO,CO00701,3,CO00701,240,0,36456641.0,600,780,600,1020,107645,2.7869385480050166,33867472.711226724
115,Boynton Beach Police Department,local_police,FL,FL05003,3,FL05003,0,0,33507073.0,640,420,640,420,80108,3.7449443251610326,41827374.29470215
116,Bradley County Sheriff's Office,sheriff,TN,TN00600,5,TN00600,0,600,17890607.0,0,488,600,488,106727,4.684850131644289,16762962.511829248
117,Brattleboro Police Department,local_police,VT,VT01302,1,VT01302,120,480,2775000.0,0,640,480,760,11257,8.88336146397797,24651328.062538862
118,Brazoria County Sheriff's Department,sheriff,TX,TX02000,3,TX02000,60,0,40852535.0,160,728,160,788,126396,2.3734928320516473,32321066.331213012
119,Brevard County Sheriff's Office,sheriff,FL,FL00500,12,FL00500,10,200,88030079.0,440,770,640,780,601942,1.9935475510929623,14624345.701080834
121,Bridgeport Police Department,local_police,CT,CT00015,1,CT00015,200,40,40131912.0,400,1340,440,1540,143525,0.6967427277477791,27961617.83661383
122,Bridgeview Police Department,local_police,IL,IL01611,1,IL01611,0,0,4000000.0,120,480,120,480,15993,6.252735571812669,25010942.287250675
124,Brockton Police Department,local_police,MA,MA01203,3,MA01203,94,480,28646214.0,0,795,480,889,95770,3.13250495979952,29911469.144826148
125,Broomfield Police Deparment,local_police,CO,CO06401,1,CO06401,0,80,29790081.0,480,556,560,556,72236,1.3843512929841078,41239937.150451295
126,Broward County Sheriff's Office,sheriff,FL,FL00600,16,FL00600,128,552,962841240.0,40,770,592,898,600244,2.6655826630503596,160408307.2883694
127,Brownsville Police Department,local_police,TX,TX03101,4,TX03101,0,0,35813008.0,160,696,160,696,183428,2.1806921516889464,19524286.36849336
129,Bryant Police Department,local_police,AR,AR06302,1,AR06302,16,500,4879244.0,0,520,500,536,21375,4.678362573099415,22826872.514619883
130,Buchanan County Sheriff's Department,sheriff,VA,VA01400,1,VA01400,0,0,3194581.0,100,750,100,750,22938,4.3595779928502925,13927025.023977678
131,Buckeye Police Department,local_police,AZ,AZ00703,2,AZ00703,0,640,20858393.0,0,585,640,585,85224,2.3467567821271005,24474787.61851122
132,Buffalo Police Department,local_police,NY,NY01401,3,NY01401,80,0,89099759.0,160,850,160,930,254479,1.1788792002483506,35012617.54408026
135,Burbank Police Department,local_police,CA,CA01912,1,CA01912,0,0,61215850.0,600,664,600,664,101866,0.9816818172893803,60094486.87491411
136,Burlington Police Department,local_police,NC,NC00101,1,NC00101,240,714,17490045.0,0,640,714,880,55599,1.7985934998830915,31457481.249662764
137,Burton Police Department,local_police,MI,MI25839,1,MI25839,0,0,5826500.0,640,594,640,594,28462,3.5134565385426186,20471154.521818567
139,Butler Police Department,local_police,PA,PA01001,1,PA01001,0,0,2300000.0,1000,799,1000,799,12847,7.783918424534911,17903012.376430295
143,Calcasieu Parish Sheriff's Office,sheriff,LA,LA01000,2,LA01000,77,1080,97332233.0,0,496,1080,573,203436,0.9831101673253505,47844153.93539
144,Caledonia Police Department,local_police,WI,WI05203,1,WI05203,0,40,4500000.0,480,720,520,720,25235,3.9627501486031305,17832375.668714087
146,Cambridge Police Department,local_police,MA,MA00911,1,MA00911,80,480,60233075.0,0,800,480,880,119192,0.8389824820457749,50534494.76474931
147,Camden County Police Department,local_police,NJ,NJ00408,3,NJ00408,0,0,72062895.0,480,840,480,840,74744,4.013700096328803,96412949.53441079
148,Cameron County Sheriff's Office,sheriff,TX,TX03100,1,TX03100,40,0,34000000.0,160,800,160,840,150000,0.6666666666666666,22666666.666666668
150,Canadian County Sheriff's Department,sheriff,OK,OK00900,1,OK00900,0,0,5091694.0,480,576,480,576,150000,0.6666666666666666,3394462.6666666665
151,Canton Police Department,local_police,NC,NC04401,1,NC04401,0,504,1630360.0,0,640,504,640,4369,22.888532845044633,37316548.409246966
152,Canton Police Department,local_police,OH,OH07604,2,OH07604,0,0,18212498.0,640,680,640,680,69963,2.8586538598973745,26031613.853036605
153,Cape Coral Police Department,local_police,FL,FL03602,4,FL03602,480,540,55249170.0,0,770,540,1250,200972,1.9903270107278623,27490978.842823874
155,Carmel Police Department,local_police,IN,IN02901,2,IN02901,80,640,23141150.0,0,600,640,680,101643,1.9676711627952737,22767086.764459923
156,Carroll County Sheriff's Department,sheriff,TN,TN00900,1,TN00900,0,0,5077757.0,480,480,480,480,28000,3.571428571428571,18134846.428571425
158,Carrollton Police Department,local_police,GA,GA02201,1,GA02201,0,0,8526622.0,600,440,600,440,27450,3.6429872495446265,31062375.2276867
159,Carrollton Police Department,local_police,TX,TX05704,3,TX05704,200,720,32000000.0,0,728,720,928,139892,2.144511480284791,22874789.123037774
162,Cartersville Police Department,local_police,GA,GA00801,1,GA00801,24,0,6129280.0,450,400,450,424,22037,4.537822752643281,27813586.24132141
163,Cary Police Department,local_police,NC,NC09203,1,NC09203,80,480,24000000.0,0,640,480,720,173587,0.5760800059912321,13825920.143789569
165,Cass County Sheriff's Department,sheriff,IN,IN00900,1,IN00900,40,720,4192305.0,0,640,720,680,19723,5.070222582771384,21255919.484865386
167,Cedar City Police Department,local_police,UT,UT01101,1,UT01101,0,0,5214072.0,0,496,0,496,36090,2.770850651149903,14447414.796342477
168,Cedar Rapids Police Department,local_police,IA,IA05701,4,IA05701,140,480,45347855.0,0,620,480,760,134027,2.984473277772389,33834865.36294925
170,Chandler Police Department,local_police,AZ,AZ00705,11,AZ00705,0,760,91348133.0,0,585,760,585,265398,4.14471849825545,34419299.69329084
171,Charles County Sheriff's Office,sheriff,MD,MD00900,1,MD00900,350,160,94754000.0,240,750,400,1100,163257,0.6125311625228933,58039777.77369423
172,Charleston County Sheriff's Office,sheriff,SC,SC01000,4,SC01000,25,480,78444983.0,0,470,480,495,350209,1.1421751011538823,22399476.598259896
173,Charleston Police Department,local_police,SC,SC01001,2,SC01001,320,480,50870319.0,0,469,480,789,139714,1.4314957699299997,36410323.23174485
174,Charleston Police Department,local_police,WV,WV02002,5,WV02002,0,672,22095156.0,0,824,672,824,45879,10.898232306719851,48159628.58824299
175,Charlotte County Sheriff's Office,sheriff,FL,FL00800,4,FL00800,0,480,77739712.0,0,770,480,770,167499,2.3880739586504993,46412045.44504743
176,Charlotte Mecklenburg Police Department,local_police,NC,NC06001,21,NC06001,360,320,282288482.0,360,640,680,1000,954695,2.1996553873226525,29568446.676687315
177,Charlottesville Police Department,local_police,VA,VA10200,1,VA10200,160,420,17357796.0,100,480,520,640,46950,2.1299254526091587,36970811.50159745
178,Chattanooga Police Department,local_police,TN,TN03301,8,TN03301,400,640,72868657.0,0,480,640,880,184742,4.330363425750506,39443470.894544825
179,Cheatham County Sheriff's Office,sheriff,TN,TN01100,2,TN01100,0,0,5586090.0,0,492,0,492,40667,4.917992475471513,13736174.293653332
180,Cheektowaga Police Department,local_police,NY,NY01455,1,NY01455,0,480,17898058.0,160,700,640,700,85452,1.1702476243973226,20945159.855825495
185,Cherry Hill Township Police Department,local_police,NJ,NJ00412,1,NJ00412,0,80,25829083.0,800,840,880,840,72037,1.3881755209128643,35855300.748226605
186,Chesapeake Police Department,local_police,VA,VA10300,2,VA10300,0,120,51985768.0,560,1040,680,1040,247011,0.8096805405427289,21045932.36738445
187,Chesterfield County Police Department,local_police,VA,VA02101,2,VA02101,720,300,68859100.0,100,480,400,1200,358245,0.5582771566944409,19221231.28026909
188,Chetek Police Department,local_police,WI,WI00303,1,WI00303,0,120,515638.0,0,720,120,720,2094,47.75549188156638,24624546.322827123
189,Cheyenne Police Department,local_police,WY,WY01101,3,WY01101,160,560,14351555.0,0,560,560,720,64742,4.633777146211115,22167302.523863953
190,Chicago Police Department,local_police,IL,ILCPD00,49,ILCPD00,0,540,1189748797.0,0,560,540,560,2677643,1.8299676245115573,44432689.38390965
191,Chino Police Department,local_police,CA,CA03602,3,CA03602,280,400,42021191.0,400,664,800,944,92290,3.2506230360819157,45531683.82273269
193,Chula Vista Police Department,local_police,CA,CA03702,3,CA03702,0,80,563765248.0,800,928,880,928,272979,1.0989856362577342,206523303.25775975
194,Cincinnati Police Department,local_police,OH,OHCIP00,8,OHCIP00,380,520,154133700.0,0,740,520,1120,304548,2.6268437159331204,50610642.657315105
195,Citrus County Sheriff's Department,sheriff,FL,FL00900,7,FL00900,0,40,29392533.0,687,770,727,770,149657,4.6773622349773145,19639931.977789212
196,Clackamas County Sheriff's Office,sheriff,OR,OR00300,14,OR00300,190,680,119752846.0,0,640,680,830,245194,5.709764512997871,48840039.315807074
198,Clanton Police Department,local_police,AL,AL01401,1,AL01401,0,240,1600000.0,0,520,240,520,8764,11.410314924691923,18256503.879507076
199,Clark County Sheriff''s Department,sheriff,OH,OH01200,1,OH01200,0,0,15000000.0,400,749,400,749,134585,0.7430248541813723,11145372.812720586
201,Clark County's Sheriff's Department,sheriff,WI,WI01000,2,WI01000,0,240,6031791.0,0,720,240,720,34748,5.755726948313572,17358671.002647635
202,Clarksdale Police Department,local_police,MS,MS01401,1,MS01401,0,0,3077412.0,0,400,0,400,14470,6.91085003455425,21267532.826537665
203,Clarkstown Police Department,local_police,NY,NY04350,1,NY04350,0,0,30418927.0,640,835,640,835,86000,1.1627906976744187,35370845.34883721
204,Clarksville Police Department,local_police,AR,AR03601,1,AR03601,0,80,1565881.0,0,522,80,522,9721,10.287007509515481,16108229.606007611
205,Clarksville Police Department,local_police,TN,TN06301,5,TN06301,200,0,31448229.0,480,480,480,680,161247,3.100832883712565,19503140.523544624
206,Clay County Sheriff's Office,sheriff,FL,FL01000,7,FL01000,0,0,59680021.0,344,770,344,770,219252,3.1926732709393755,27219829.693685804
208,Clayton County Police Department,local_police,GA,GA03101,7,GA03101,160,0,39207499.0,400,408,400,568,233265,3.0008788287998627,16808136.239898827
209,Clearlake Police Department,local_police,CA,CA01702,1,CA01702,216,240,6242187.0,400,664,640,880,15179,6.588049278608604,41123835.562290005
210,Clearwater Police Department,local_police,FL,FL05203,3,FL05203,0,800,45096056.0,0,770,800,770,116552,2.573958404832178,38691790.78866086
211,Cleburne County Sheriff's Office,sheriff,AL,AL01800,2,AL01800,80,0,1854180.0,0,540,0,620,14000,14.285714285714285,13244142.857142856
212,Cleveland County Sheriff's Office,sheriff,NC,NC02300,1,NC02300,0,525,8756593.0,0,640,525,640,64000,1.5625,13682176.5625
213,Cleveland Police Department,local_police,OH,OHCLP00,8,OHCLP00,441,1040,206566803.0,0,740,1040,1181,378589,2.1131094669945507,54562283.37326229
214,Cleveland Police Department,local_police,TN,TN00601,2,TN00601,0,520,11400000.0,0,410,520,410,45948,4.352746583093932,24810655.523635413
215,Clinton Police Department,local_police,IL,IL02001,1,IL02001,0,480,1278267.0,0,560,480,560,6733,14.852220406950838,18985103.22293183
217,Cloverdale Police Department,local_police,CA,CA04901,1,CA04901,224,160,3900000.0,320,664,480,888,8803,11.359763716914689,44303078.495967284
218,Clovis Police Department,local_police,CA,CA01001,2,CA01001,0,520,39000000.0,400,664,920,664,117662,1.6997841274158183,33145790.484608456
219,Cobb County Police Department,local_police,GA,GA03302,19,GA03302,270,500,78881622.0,0,408,500,678,565304,3.361023449329918,13953841.11911467
220,Coconut Creek Police Department,local_police,FL,FL00611,1,FL00611,0,0,2356680.0,752,770,752,770,61128,1.6359115299044626,3855319.984295249
222,Colby Police Department,local_police,KS,KS09701,1,KS09701,0,336,970789.0,0,560,336,560,5315,18.81467544684854,18265079.96237065
223,College Station Police Department,local_police,TX,TX02102,4,TX02102,0,0,24117375.0,160,696,160,696,119260,3.3540164346805295,20222518.027838334
224,Collier County Sheriff's Office,sheriff,FL,FL01100,4,FL01100,120,672,188878600.0,0,770,672,890,356027,1.123510295567471,53051762.92809253
225,Collierville Police Department,local_police,TN,TN07901,1,TN07901,0,0,13239865.0,536,480,536,480,51441,1.9439746505705564,25737961.93697634
226,Colorado Springs Police Department,local_police,CO,CO02101,24,CO02101,468,600,130833487.0,0,556,600,1024,482131,4.977900197249295,27136501.697671376
228,Columbia Police Department,local_police,MO,MO01002,4,MO01002,0,0,22836305.0,600,480,600,480,124769,3.2059245485657497,18302867.699508693
229,Columbia Police Department,local_police,SC,SC04001,1,SC04001,0,575,42366353.0,0,480,575,480,132130,0.7568303943086355,32064143.64640884
230,Columbus Police Department,local_police,GA,GA10601,4,GA10601,320,384,26475666.0,0,408,384,728,196442,2.0362244326569674,13477599.49501634
231,Columbus Police Department,local_police,MS,MS04401,2,MS04401,0,0,3500000.0,360,480,360,480,23307,8.581112970352255,15016947.698116446
232,Columbus Police Department,local_police,OH,OHCOP00,37,OHCOP00,463,600,346300151.0,0,737,600,1200,903852,4.093590543584569,38313811.4425813
233,Commerce City Police Department,local_police,CO,CO00103,4,CO00103,0,600,18593352.0,0,556,600,556,59317,6.743429371006625,31345738.995566197
235,Concord Police Department,local_police,CA,CA00704,2,CA00704,60,80,60534810.0,640,1080,720,1140,128544,1.5558874782175753,47092676.43764003
236,Concord Police Department,local_police,NC,NC01301,3,NC01301,0,0,23645524.0,24,600,24,600,98500,3.0456852791878175,24005608.121827412
238,Conroe Police Department,local_police,TX,TX17001,3,TX17001,140,320,20231130.0,0,643,320,783,96214,3.1180493483276863,21027220.5708109
240,Conway Police Department,local_police,AR,AR02301,1,AR02301,0,0,12153310.0,480,520,480,520,68100,1.4684287812041115,17846270.19089574
241,Coos County Sheriff's Office,sheriff,OR,OR00600,2,OR00600,0,0,12500000.0,480,400,480,400,63500,3.149606299212598,19685039.37007874
242,Coral Gables Police Department,local_police,FL,FL01302,1,FL01302,0,760,46830049.0,0,770,760,770,49130,2.0354162426216162,95318642.37736617
243,Corona Police Department,local_police,CA,CA03315,5,CA03315,306,400,46694832.0,400,664,800,970,170996,2.924045006900746,27307558.071533836
244,Corpus Christi Police Department,local_police,TX,TX17802,14,TX17802,690,760,80933540.0,160,696,920,1386,327248,4.278101012076468,24731561.38463795
245,Costa Mesa Police Department,local_police,CA,CA03004,1,CA03004,320,320,49720046.0,400,664,720,984,112366,0.889948916932168,44248301.087517574
246,Council Bluffs Police Department,local_police,IA,IA07801,1,IA07801,0,32,17867084.0,600,700,632,700,62216,1.6073035875016073,28717828.211392567
247,Covington Police Department,local_police,KY,KY05901,1,KY05901,0,800,15817928.0,0,824,800,824,40314,2.4805278563278264,39236811.03338791
248,Covington Police Department,local_police,VA,VA10600,1,VA10600,0,0,2292102.0,504,480,504,480,5639,17.733640716439083,40647313.353431456
249,Coweta County Sheriff's Department,sheriff,GA,GA03800,3,GA03800,40,0,23811019.0,504,408,504,448,103509,2.898298698663884,23003815.127187006
251,Cranston Police Department,local_police,RI,RI00402,1,RI00402,40,512,25540262.0,0,800,512,840,81142,1.2324073845850483,31476007.493036896
252,Crowley Police Department,local_police,LA,LA00101,2,LA00101,0,0,3379073.0,450,400,450,400,12520,15.974440894568689,26989400.95846645
254,Culver City Police Department,local_police,CA,CA01918,3,CA01918,80,800,48174584.0,0,664,800,744,38471,7.798081671908711,125223113.51407553
255,Cumberland County Sheriff's Office,sheriff,KY,KY02900,2,KY02900,0,16,341000.0,40,860,56,860,6856,29.171528588098017,4973745.624270712
257,Cumberland County Sheriff's Office,sheriff,TN,TN01800,2,TN01800,40,40,8811066.0,360,480,400,520,62084,3.2214419174022293,14192168.674698796
258,Cuyahoga County Sheriff's Department,sheriff,OH,OH01800,1,OH01800,0,0,141025897.0,0,579,0,579,1235000,0.08097165991902834,11419100.97165992
260,Dallas (N.C.) Police Department,local_police,NC,NC03604,1,NC03604,0,0,1809360.0,504,648,504,648,4851,20.614306328592043,37298701.2987013
261,Dallas Police Department,local_police,TX,TXDPD00,21,TXDPD00,0,0,486752691.0,800,1400,800,1400,1343266,1.563353795897462,36236507.95895973
262,Daly City Police Department,local_police,CA,CA04106,1,CA04106,276,320,30109785.0,400,664,720,940,105868,0.9445724864926134,28440874.485207994
263,Danbury Police Department,local_police,CT,CT00034,1,CT00034,10,80,18349168.0,400,1340,480,1350,84317,1.1860004506801713,21762121.517606176
264,Dane County Sheriff's Office,sheriff,WI,WI01300,3,WI01300,289,455,79803554.0,0,944,455,1233,556189,0.5393849932307183,14348279.811359089
265,Danville Police Department,local_police,VA,VA10700,2,VA10700,0,400,9934080.0,100,920,500,920,39869,5.016428804334194,24916802.528280117
266,Davenport Police Department,local_police,IA,IA08202,4,IA08202,0,0,18176346.0,800,480,800,480,101799,3.9293116828259613,17855132.17222173
267,Davidson County Sheriff's Office,sheriff,NC,NC02900,6,NC02900,0,796,17778548.0,0,660,796,660,162878,3.6837387492479037,10915254.362160636
268,Davie Police Department,local_police,FL,FL00612,2,FL00612,0,800,52000000.0,0,770,800,770,106621,1.8758030781928512,48770880.033014126
269,Davis County Sheriff's Office,sheriff,UT,UT00600,2,UT00600,0,400,13819810.75,0,594,400,594,27740,7.209805335255949,49819072.63878876
270,Daytona Beach Police Department,local_police,FL,FL06401,5,FL06401,0,588,38947920.0,0,770,588,770,70143,7.128295054388891,55526453.10294684
271,Dayton Police Department,local_police,OH,OH05702,6,OH05702,623,24,53160300.0,0,737,24,1360,139907,4.288563116927674,37996883.64413503
272,Deaf Smith County Sheriff's Office,sheriff,TX,TX05900,1,TX05900,0,0,3035713.0,480,820,480,820,18561,5.387640752114649,16355331.070524218
273,Dearborn Police Department,local_police,MI,MI82343,6,MI82343,188,800,44000000.0,0,594,800,782,93367,6.426253387171056,47125858.172587745
274,Decatur Police Department,local_police,AL,AL05201,1,AL05201,360,560,15250884.0,0,560,560,920,54381,1.8388775491440024,28044508.19219948
275,Decatur Police Department,local_police,IL,IL05802,1,IL05802,80,480,28240407.0,0,560,480,640,70007,1.4284285857128574,40339404.63096548
276,Defiance Police Department,local_police,OH,OH02001,1,OH02001,0,480,3127510.0,0,740,480,740,16482,6.067224851352991,18975306.394854993
277,DeKalb County Police Department,local_police,GA,GA04402,14,GA04402,632,480,95079379.0,0,408,480,1040,523407,2.6747827216678415,18165477.15257916
278,Delaware County Sheriff's Department,sheriff,OH,OH02100,2,OH02100,0,0,26006725.0,560,740,560,740,209000,0.9569377990430623,12443409.090909092
279,Delray Beach Police Department,local_police,FL,FL05004,1,FL05004,0,0,38257150.0,760,770,760,770,69577,1.4372565646693591,54985339.98304037
280,Del Rio Police Department,local_police,TX,TX23301,2,TX23301,0,0,5648000.0,250,696,250,696,35722,5.598790661217177,15810984.827277308
281,Denison Police Department,local_police,TX,TX09102,1,TX09102,0,520,6100000.0,160,720,680,720,25792,3.8771712158808938,23650744.41687345
282,Denton County Sheriff's Office,sheriff,TX,TX06100,6,TX06100,80,0,61785769.0,760,650,760,730,300000,2.0,20595256.333333332
283,Denton Police Department,local_police,TX,TX06102,3,TX06102,20,0,36122872.0,800,696,800,716,147515,2.0336914890011184,24487592.448225606
284,Denver Police Department,local_police,CO,CODPD00,41,CODPD00,476,640,244371249.0,0,556,640,1032,735538,5.574151165541413,33223470.303369775
285,DeRidder Police Department,local_police,LA,LA00601,1,LA00601,0,0,3052800.0,640,496,640,496,10521,9.5047999239616,29016253.207869977
287,Des Moines Police Department,local_police,IA,IA07703,5,IA07703,80,40,57075436.0,120,1000,160,1080,212312,2.3550246806586532,26882812.08787068
288,DeSoto County Sheriff's Department,sheriff,MS,MS01700,3,MS01700,0,720,24000000.0,0,490,720,490,45200,6.6371681415929205,53097345.13274336
289,Detroit Police Department,local_police,MI,MI82349,23,MI82349,80,800,330015742.0,0,594,800,674,665369,3.4567285220682056,49598905.569691405
291,Dewey County Sheriff's Department,sheriff,OK,OK02200,1,OK02200,0,40,928000.0,160,576,200,576,4500,22.22222222222222,20622222.222222224
292,Dickenson County Sheriff's Office,sheriff,VA,VA02600,1,VA02600,0,80,1390165.0,0,40,80,40,14756,6.776904310111141,9421015.180265656
293,Dickinson Police Department,local_police,ND,ND04501,1,ND04501,0,120,5770205.0,0,480,120,480,23527,4.25043566965614,24525885.153228205
295,Dona Ana Sheriff's Department,sheriff,NM,NM00700,6,NM00700,134,560,20890554.0,0,675,560,809,115000,5.217391304347826,18165699.130434785
296,Doral Police Department,local_police,FL,FL01311,1,FL01311,0,680,23790455.0,0,770,680,770,67792,1.475100306820864,35093307.469907954
299,Dothan Police Department,local_police,AL,AL03801,2,AL03801,0,280,27000000.0,456,560,736,560,69414,2.8812631457631026,38897052.467801884
300,Douglas County Sheriff's Department,sheriff,CO,CO01800,7,CO01800,24,480,66835232.0,0,556,480,580,351154,1.9934273851358661,19033025.965815566
301,Douglas County Sheriff's Department,sheriff,GA,GA04800,6,GA04800,0,0,33862486.0,672,408,672,408,112351,5.340406404927415,30139906.18686082
302,Douglas County Sheriff's Department,sheriff,NE,NB02800,2,NB02800,0,400,16786749.0,160,600,560,600,571327,0.35006222356023786,2938203.3406437994
303,Douglas County Sheriff's Office,sheriff,NV,NV00300,2,NV00300,0,0,17401378.0,440,1142,440,1142,48905,4.089561394540436,35582001.84030263
304,Douglas Police Department,local_police,GA,GA03401,1,GA03401,0,160,3700000.0,0,440,160,440,11612,8.611780916293489,31863589.39028591
305,Downey City Police Department,local_police,CA,CA01920,1,CA01920,320,520,36459012.0,400,664,920,984,109202,0.9157341440632956,33386762.14721342
306,Duluth Police Department,local_police,MN,MN06906,2,MN06906,440,672,24067792.0,0,0,672,440,85773,2.331736094108869,28059869.655952338
307,Dumas Police Department,local_police,TX,TX17101,1,TX17101,0,0,2700000.0,640,700,640,700,13612,7.346459006758743,19835439.318248607
309,Durham County Sheriff's Office,sheriff,NC,NC03200,1,NC03200,0,0,39000000.0,480,618,480,618,45000,2.2222222222222223,86666666.66666667
310,Durham Police Department,local_police,NC,NC03201,5,NC03201,491,800,67553520.0,0,640,800,1131,285897,1.7488815902230526,23628621.496552955
311,Dyer County Sheriff's Department,sheriff,TN,TN02300,2,TN02300,40,0,3155339.0,80,480,80,520,38750,5.161290322580645,8142810.322580645
314,East Hartford Police Department,local_police,CT,CT00043,1,CT00043,0,0,13000000.0,400,1340,400,1340,49630,2.014910336490026,26193834.37437034
315,East Point Police Department,local_police,GA,GA06002,1,GA06002,0,21,12500000.0,0,440,21,440,35042,2.8537183950687743,35671479.938359685
318,Ector County Sheriff's Office,sheriff,TX,TX06800,5,TX06800,0,0,26095775.0,160,667,160,667,174749,2.8612467024131756,14933290.033133237
320,Edinburg Police Department,local_police,TX,TX10804,4,TX10804,0,200,22488596.0,500,643,700,643,102374,3.9072420731826436,21967097.114501726
321,Edison Township Police Department,local_police,NJ,NJ01205,1,NJ01205,870,800,31783301.0,100,100,900,970,98721,1.0129557034470882,32195076.02232554
322,Edmond Police Department,local_police,OK,OK05503,2,OK05503,224,0,26304104.0,560,600,560,824,95346,2.0976233926960752,27588051.937155206
323,El Cajon Police Department,local_police,CA,CA03705,3,CA03705,80,160,37301719.0,480,928,640,1008,102401,2.9296588900499017,36427104.22749778
324,El Dorado County Sheriff's Office,sheriff,CA,CA00900,1,CA00900,0,440,95153888.0,400,956,840,956,157594,0.6345419241849309,60379131.18519741
325,Elgin Police Department,local_police,IL,IL04506,1,IL04506,247,0,46534881.0,660,560,660,807,110196,0.9074739554974772,42229192.529674396
326,Elizabethtown Police Department,local_police,KY,KY04701,4,KY04701,0,0,7200000.0,560,800,560,800,30331,13.187827635092809,23738089.743167054
327,Elk City Police Department,local_police,OK,OK00501,2,OK00501,25,25,2300000.0,800,680,825,705,11354,17.61493746697199,20257178.08701779
328,Elk Grove Police Department,local_police,CA,CA0340H,2,CA0340H,0,40,40333488.0,800,939,840,939,177302,1.1280188604753472,22748467.586378045
330,El Mirage Police Department,local_police,AZ,AZ00707,3,AZ00707,0,0,8719013.0,640,750,640,750,36481,8.223458786765713,23900148.02225816
331,El Monte Police Department,local_police,CA,CA01922,4,CA01922,350,280,31701296.0,400,664,680,1014,112344,3.5604927721996726,28218058.819340598
332,Elmore County Sheriff's Department,sheriff,ID,ID02000,3,ID02000,80,80,6113716.0,800,1500,880,1580,27511,10.904729017483914,22222805.42328523
333,El Paso County Sheriff's Department,sheriff,TX,TX07100,4,TX07100,0,0,102000000.0,720,643,720,643,835793,0.4785874014259512,12203978.736361755
334,El Paso County Sheriff's Office,sheriff,CO,CO02100,8,CO02100,244,160,79539332.0,0,556,160,800,720403,1.1104895454349857,11040949.579610301
335,El Paso Police Department,local_police,TX,TX07102,15,TX07102,377,0,148322299.0,0,643,0,1020,681534,2.2009173423482906,21763008.00840457
337,Erie Police Department,local_police,PA,PA02502,1,PA02502,0,68,30569540.0,128,919,196,919,95077,1.0517790843211292,32152402.789318133
339,Escondido Police Department,local_police,CA,CA03706,5,CA03706,0,24,45928260.0,480,928,504,928,149943,3.3346004815163095,30630479.582241252
342,Eureka County Sheriff's Department,,NV,NV00600,1,NV00600,0,688,3003000.0,0,840,688,840,2500,40.0,120120000.0
343,Eustis Police Department,local_police,FL,FL03501,1,FL03501,0,630,5384323.0,0,770,630,770,21328,4.688672168042011,25245325.393848464
345,Evansville Police Department,local_police,IN,IN08201,13,IN08201,0,800,33816076.0,0,554,800,554,118407,10.979080628679048,28559186.53457988
348,Fairfax County Police Department,local_police,VA,VA02901,4,VA02901,540,383,220985727.0,100,480,483,1020,1109756,0.3604395921265576,19913001.3264177
349,Fairfax County Sheriff's Office,sheriff,VA,VA02901,1,VA02901,540,383,220985727.0,100,480,483,1020,1109756,0.0901098980316394,19913001.3264177
351,Fairfield Police Department,local_police,CA,CA04803,3,CA04803,0,160,42887273.0,600,860,760,860,117580,2.5514543289675116,36474972.78448716
352,Fairfield Police Department,local_police,CT,CT00051,1,CT00051,0,0,14850217.0,400,940,400,940,62215,1.6073294221650727,23869190.70963594
357,Fargo Police Department,local_police,ND,ND00902,3,ND00902,54,620,21348525.0,60,400,680,454,125209,2.395993898202206,17050311.878539085
358,Farmington Hills Police Department,local_police,MI,MI63389,1,MI63389,0,80,21700000.0,720,664,800,664,80017,1.2497344314333203,27119237.162103053
359,Farmington Police Department,local_police,NM,NM02402,6,NM02402,80,560,18100000.0,0,880,560,960,44156,13.588187335809403,40991031.79635836
360,Farmington Police Department,local_police,UT,UT00605,2,UT00605,0,640,2541584.0,0,542,640,542,25387,7.878047819750266,10011360.14495608
363,Fayetteville Police Department,local_police,AR,AR07201,2,AR07201,0,0,14610196.0,720,528,720,528,89576,2.232740912744485,16310391.176207913
364,Fayetteville Police Department,local_police,NC,NC02601,8,NC02601,160,480,56000000.0,0,640,480,800,211705,3.7788432016249027,26451902.41137432
365,Federal Way Police Department,local_police,WA,WA01736,7,WA01736,0,560,33362775.0,0,720,560,720,96307,7.268422856074844,34642108.050297484
366,Fife Police Department,local_police,WA,WA02707,1,WA02707,0,24,7661612.0,560,720,584,720,10458,9.562057754828839,73260776.43908969
367,Fishers Police Department,local_police,IN,IN02907,1,IN02907,24,800,16619322.0,0,600,800,624,97020,1.0307153164296021,17129789.73407545
368,Flagstaff Police Department,local_police,AZ,AZ00301,7,AZ00301,0,0,22451005.0,640,585,640,585,73939,9.467263555092712,30364225.91595775
371,Florence County Sheriff's Office,sheriff,SC,SC02100,4,SC02100,0,0,18504502.0,160,480,160,480,138325,2.89174046629315,13377554.310500631
372,Florence Police Department,local_police,AL,AL04101,2,AL04101,0,0,11450608.0,504,520,504,520,41166,4.858378273332361,27815692.56182286
374,Floyd County Police Department,local_police,GA,GA05701,2,GA05701,0,0,5519715.0,440,440,440,440,60766,3.2913142217687525,9083558.239805155
376,Fontana Police Department,local_police,CA,CA03604,10,CA03604,0,0,60908820.0,800,960,800,960,216173,4.62592460668076,28175960.920188922
378,Forest Park Police Department,local_police,GA,GA03102,1,GA03102,0,504,9644212.0,0,408,504,408,19871,5.032459362890645,48534104.97710231
379,Forest Park Police Department,local_police,IL,IL01635,2,IL01635,0,0,4938000.0,120,580,120,580,13534,14.777597162701346,36485887.394709624
382,Forsyth County Sheriff's Department,sheriff,GA,GA05800,5,GA05800,0,0,47590754.0,600,408,600,408,222074,2.2515017516683624,21430133.19884363
383,Forsyth County Sheriff's Department,sheriff,NC,NC03400,2,NC03400,0,90,59469255.0,429,640,519,640,385374,0.518976371005828,15431569.073160099
384,Fort Bend County Sheriff's Office,sheriff,TX,TX07900,2,TX07900,222,680,79093090.0,160,772,840,994,517339,0.38659370354835026,15288445.294091495
386,Fort Lauderdale Police Department,local_police,FL,FL00603,4,FL00603,160,520,128073352.0,0,770,520,930,184245,2.1710222801161496,69512525.17028956
387,Fort Morgan Police Department,local_police,CO,CO04402,1,CO04402,0,12,3766680.0,680,556,692,556,11249,8.889679082585118,33484576.406791713
388,Fort Myers Police Department,local_police,FL,FL03601,2,FL03601,0,160,51698000.0,480,770,640,770,91086,2.1957271150341438,56757350.19651758
389,Fort Pierce Police Department,local_police,FL,FL05601,3,FL05601,0,240,14396550.0,560,770,800,770,46343,6.473469563903934,31065209.41674039
390,Fort Smith Police Department,local_police,AR,AR06601,2,AR06601,80,640,19896590.0,0,520,640,600,87764,2.2788387037965454,22670559.682785653
391,Fort Wayne Police Department,local_police,IN,IN00201,5,IN00201,24,0,61246739.0,0,912,0,936,272398,1.8355494533733727,22484283.658470325
393,Fountain Inn Police Department,local_police,SC,SC02301,1,SC02301,0,0,2351086.0,320,480,320,480,10905,9.170105456212747,21559706.556625403
396,Franklin County Sheriff's Office,sheriff,KY,KY03700,1,KY03700,0,0,2845959.0,520,800,520,800,50485,1.9807863721897592,5637236.803010795
397,Franklin County Sheriff's Office,sheriff,OH,OH02500,7,OH02500,68,944,152210268.0,60,680,1004,748,99801,7.013957775974189,152513770.4031022
399,Franklin Township Police (Somerset Co.),local_police,NJ,NJ01808,1,NJ01808,0,20,15310000.0,350,650,370,650,66033,1.514394317992519,23185377.008465465
400,Frederick County Sheriff's Office,sheriff,MD,MD01100,3,MD01100,0,0,49557532.0,400,1168,400,1168,260000,1.1538461538461537,19060589.230769232
401,Frederick County Sheriff's Office,sheriff,VA,VA03400,1,VA03400,240,320,15860951.0,160,480,480,720,91593,1.0917864902339698,17316772.024062973
402,Frederick Police Department,local_police,MD,MD01103,2,MD01103,0,0,33555209.0,400,1340,400,1340,73308,2.728215201615104,45772915.64358597
403,Freeport Police Department,local_police,TX,TX02005,1,TX02005,0,0,4636779.0,160,690,160,690,12126,8.246742536698004,38238322.612568036
404,Fremont Police Department,local_police,CA,CA00105,9,CA00105,336,396,93307865.0,440,664,836,1000,234569,3.836824132771168,39778429.80103935
405,Fresno County Sheriff's Office,sheriff,CA,CA01000,7,CA01000,400,50,243308215.0,600,668,650,1068,175561,3.987218117919128,138588989.0123661
406,Fresno Police Department,local_police,CA,CA01005,24,CA01005,376,400,195181200.0,400,664,800,1040,530267,4.526021796566635,36808098.561667986
407,Fruita Police Department,local_police,CO,CO03902,1,CO03902,0,640,2134082.0,0,556,640,556,14295,6.995452955578874,14928870.234347675
408,Fullerton Police Department,local_police,CA,CA03008,4,CA03008,500,680,47794875.0,400,664,1080,1164,139921,2.8587560123212383,34158471.56609801
409,Fulton County Sheriff's Department,sheriff,IL,IL02900,2,IL02900,0,480,3868165.0,0,560,480,560,17000,11.76470588235294,22753911.76470588
411,Gadsden Police Department,local_police,AL,AL03102,3,AL03102,500,680,10065130.0,0,520,680,1020,34816,8.61672794117647,28909495.634191174
412,Gainesville Police Department,local_police,FL,FL00101,1,FL00101,320,560,35107907.0,0,770,560,1090,135004,0.7407187935172291,26005086.515955083
415,Galveston County Sheriff's Office,sheriff,TX,TX08400,1,TX08400,40,0,48590812.0,320,740,320,780,94963,1.0530417109821721,51168151.80649306
417,Garden Grove Police Department,local_police,CA,CA03009,4,CA03009,0,640,59303020.0,0,984,640,984,171366,2.3341853109718382,34606059.54506728
418,Garfield County Sheriff's Office,sheriff,CO,CO02300,1,CO02300,74,0,20436816.0,670,556,670,630,24400,4.098360655737705,83757442.62295082
419,Garfield County Sheriff’s Office,sheriff,OK,OK02400,1,OK02400,0,0,1500000.0,0,583,0,583,61000,1.639344262295082,2459016.393442623
420,Garland Police Department,local_police,TX,TX05711,6,TX05711,267,760,57800000.0,0,696,760,963,238139,2.519536909116104,24271538.891151804
421,Gary Police Department,local_police,IN,IN04505,6,IN04505,0,40,12570992.0,600,960,640,960,74693,8.032881260626832,16830214.344048306
422,Gaston County Police Department,local_police,NC,NC03605,4,NC03605,0,0,14500000.0,680,640,680,640,86383,4.630540731393909,16785710.15130292
423,Gastonia Police Department,local_police,NC,NC03606,5,NC03606,0,640,19933078.0,0,640,640,640,77640,6.439979392065945,25673722.308088616
424,Genesee County Sheriff's Office,sheriff,MI,MI25125,1,MI25125,80,80,32569709.0,80,680,160,760,405000,0.2469135802469136,8041903.456790124
425,Genesse County Sheriff's Department,sheriff,NY,NY01800,1,NY01800,0,0,11245341.0,720,830,720,830,60000,1.6666666666666667,18742235.0
426,Georgetown County Sheriff's Office,sheriff,SC,SC02200,1,SC02200,0,160,15168000.0,0,480,160,480,63000,1.5873015873015872,24076190.476190478
427,Georgetown Police Department,local_police,KY,KY10501,1,KY10501,0,0,5800000.0,560,824,560,824,35847,2.7896337210924207,16179875.582336038
428,Germantown Police Department,local_police,TN,TN07902,1,TN07902,0,0,13903958.0,468,480,468,480,39186,2.5519318123819734,35481952.73822284
429,Gilbert Police Department,local_police,AZ,AZ00711,4,AZ00711,135,640,59942830.0,0,585,640,720,257658,1.5524454897577409,23264494.019203752
431,Glendale Police Department,local_police,AZ,AZ00713,17,AZ00713,0,0,91060979.0,640,960,640,960,255307,6.6586501741041175,35667247.2748495
432,Glendale Police Department,local_police,CA,CA01925,1,CA01925,0,24,94746978.0,800,100,824,100,197747,0.5056966730215882,47913231.55344961
434,Goodyear Police Department,local_police,AZ,AZ00715,3,AZ00715,0,640,27412700.0,0,585,640,585,90622,3.3104544150427047,30249497.914413717
436,Goshen Police Department,local_police,IN,IN02002,1,IN02002,0,468,7223575.0,0,617,468,617,34168,2.9267150550222434,21141345.7035823
437,Grady County Sheriff's Office,sheriff,GA,GA06500,1,GA06500,20,0,1384029.0,40,400,40,420,30000,3.3333333333333335,4613430.0
438,Grafton Police Department,local_police,WV,WV04601,1,WV04601,0,0,400000.0,320,640,320,640,4968,20.128824476650564,8051529.790660225
440,Grand Prarie Police Department,local_police,TX,TX05712,4,TX05712,416,0,57779900.0,680,696,680,1112,195272,2.048424761358515,29589444.46720472
441,Grand Rapids Police Department,local_police,MI,MI41436,2,MI41436,320,800,56200108.0,0,594,800,914,200031,0.9998450240212768,28095699.166629177
442,Granite County Sheriff's Department,sheriff,MT,MT02000,1,MT02000,0,80,812384.0,460,400,540,400,3311,30.20235578375113,24535910.60102688
443,Greece Police Department,local_police,NY,NY02754,2,NY02754,260,288,17403331.0,160,700,448,960,95285,2.0989662591173848,18264502.282625806
444,Greeley Police Department,local_police,CO,CO06202,11,CO06202,160,520,29005474.0,0,687,520,847,108958,10.095633179757337,26620784.155362617
445,Green Bay Police Department,local_police,WI,WI00502,3,WI00502,0,170,26393441.0,595,720,765,720,103836,2.8891713856465966,25418391.5019839
446,Greene County Sheriff,sheriff,MO,MO03900,2,MO03900,0,480,27855118.0,0,600,480,600,106356,1.8804768889390349,26190452.818834856
447,Greenfield Police Department,local_police,WI,WI04108,2,WI04108,0,0,9855414.0,720,720,720,720,37183,5.378802140763252,26505160.96065406
448,Greensboro Police Department,local_police,NC,NC04102,6,NC04102,320,136,78902453.0,480,640,616,960,297878,2.0142474435842863,26488177.37462988
449,Greenville County Sheriff's Department,sheriff,SC,SC02300,17,SC02300,320,588,51784088.0,0,469,588,789,541384,3.140100187667164,9565130.849821936
451,Greenville Police Department,local_police,NC,NC07403,5,NC07403,0,600,24501924.0,0,675,600,675,94779,5.275430211333735,25851638.021080617
452,Greenville Police Department,local_police,SC,SC02302,2,SC02302,40,672,27150611.0,0,480,672,520,72227,2.769047586082767,37590666.92511111
454,Gresham Police Department,local_police,OR,OR02601,4,OR02601,0,800,41684130.0,0,640,800,640,110031,3.635339131699249,37883987.23995965
455,Gretna Police Department,local_police,LA,LA02601,1,LA02601,130,250,9600000.0,0,496,250,626,17615,5.676979846721544,54499006.52852682
456,Guadalupe County Sheriff's Office,sheriff,TX,TX09400,2,TX09400,0,360,23708343.0,160,643,520,643,64620,3.095017022593624,36688862.5812442
457,Guilford County Sheriff's Office,sheriff,NC,NC04100,3,NC04100,0,0,67929679.0,672,640,672,640,546308,0.5491407777297789,12434318.918998076
458,Gulfport Police Department,local_police,MS,MS02402,7,MS02402,80,0,18500700.0,672,530,672,610,71438,9.798706570732664,25897561.52187911
459,Gunnison Police Department,local_police,CO,CO02601,1,CO02601,109,480,626099.0,0,556,480,665,6840,14.619883040935672,9153494.152046783
462,Gwinnett County Police Department,local_police,GA,GA06702,12,GA06702,464,504,147811103.0,0,408,504,872,800166,1.4996888145709766,18472554.81987488
464,Hall County Sheriff's Department,sheriff,GA,GA06900,5,GA06900,0,480,39623486.0,0,420,480,420,204441,2.445693378529747,19381379.468893226
465,Hamilton County Sheriff's Office,sheriff,TN,TN03300,7,TN03300,0,720,59065347.0,0,480,720,480,120000,5.833333333333334,49221122.5
466,Hamilton Police Department,local_police,NJ,NJ01103,1,NJ01103,40,500,24076072.0,160,840,660,880,86722,1.1531099375014413,27762357.8792002
468,Hamilton Township Police Department,local_police,OH,OH08310,1,OH08310,0,0,3200000.0,360,737,360,737,27503,3.6359669854197723,11635094.353343273
470,Harford County Sheriff's Office,sheriff,MD,MD01300,4,MD01300,250,400,86987548.0,240,750,640,1000,255441,1.5659193316656292,34053870.75684796
471,Harnett County Sheriff's Department,sheriff,NC,NC04300,4,NC04300,0,0,12016312.0,160,640,160,640,109395,3.656474244709539,10984333.836098542
473,Harris County Sheriff's Office,sheriff,TX,TX10100,34,TX10100,355,480,512408018.0,0,696,480,1051,2200000,1.5454545454545454,23291273.545454547
474,Harrisonburg Police Department,local_police,VA,VA11200,2,VA11200,400,620,12846615.0,100,480,720,880,53204,3.7591158559506805,24145957.070896927
475,Harrison County Sheriff's Department,sheriff,IN,IN03100,2,IN03100,0,0,6708484.0,640,600,640,600,39000,5.128205128205128,17201241.025641024
476,Harrison County Sheriff's Department,sheriff,MS,MS02400,3,MS02400,0,42,19923230.0,0,480,42,480,55250,5.429864253393665,36060144.79638009
477,Harrison County Sheriff's Department,sheriff,TX,TX10200,4,TX10200,0,0,7527147.0,160,775,160,775,67000,5.970149253731343,11234547.76119403
478,Harrison Police Department,local_police,AR,AR00501,1,AR00501,0,0,3617844.0,480,520,480,520,13139,7.610929294466854,27535154.88241114
479,Hartford Police Department,local_police,CT,CT00064,2,CT00064,18,80,46627694.0,400,940,480,958,121535,1.6456164890772207,38365651.04702349
481,Hattiesburg Police Department,local_police,MS,MS01801,3,MS01801,160,48,7700400.0,96,480,144,640,45806,6.5493603458062255,16810898.13561542
483,Hawaii County Sheriff's Department,sheriff,HI,HI00100,2,HI00100,0,0,66055816.0,640,960,640,960,203340,0.983574309039048,32485401.790105246
484,Hawaii Police Department,local_police,HI,HI00100,11,HI00100,0,0,66055816.0,640,960,640,960,203340,5.409658699714764,32485401.790105246
485,Hays County Sheriff's Department,sheriff,TX,TX10500,4,TX10500,661,480,44967209.0,160,643,640,1304,108314,3.6929667448344627,41515601.86125524
486,Hayward Police Department,local_police,CA,CA00106,5,CA00106,400,0,81545000.0,800,664,800,1064,157966,3.1652380892090703,51621867.99691073
487,Heard County Sheriff's Office,sheriff,GA,GA07400,1,GA07400,56,30,2000000.0,720,408,750,464,12000,8.333333333333334,16666666.666666668
489,Henderson Police Department,local_police,NV,NV00203,10,NV00203,1000,680,96704504.0,0,480,680,1480,329172,3.0379254614608775,29378107.493954528
490,Hendersonville Police Department,local_police,TN,TN08304,1,TN08304,400,320,12700000.0,0,480,320,880,59323,1.6856868331001467,21408222.78037186
491,Henrico County Police Department,local_police,VA,VA04301,3,VA04301,636,190,79000000.0,160,480,350,1116,333766,0.8988333143579633,23669277.278093036
492,Henry County Police Department,local_police,GA,GA07505,3,GA07505,40,400,24209407.0,0,408,400,448,194282,1.544147167519379,12460962.415457943
493,Henry County Sheriff's Office,sheriff,VA,VA04400,2,VA04400,0,0,12052088.0,120,960,120,960,50557,3.955930929445972,23838613.841802325
494,Hernando County Sheriff's Department,sheriff,FL,FL02700,10,FL02700,0,0,55153255.0,600,770,600,770,193920,5.156765676567657,28441241.23349835
495,Hialeah Police Department,local_police,FL,FL01304,3,FL01304,0,160,56724640.0,560,780,720,780,232027,1.2929529753002884,24447430.68694592
496,Hickory Police Department,local_police,NC,NC01802,1,NC01802,0,644,13197042.0,0,640,644,640,41473,2.4112072914908493,31820803.896510985
497,Hidalgo County Sheriff's Office,sheriff,TX,TX10800,3,TX10800,180,160,70258090.0,0,696,160,876,868707,0.3453408341362508,8087662.468473259
498,Highlands County Sheriff's Department,sheriff,FL,FL02800,4,FL02800,0,688,35388170.0,0,770,688,770,106221,3.7657337061409697,33315606.14191167
499,High Point Police Department,local_police,NC,NC04103,1,NC04103,0,800,29461133.0,0,640,800,640,113565,0.8805529872760093,25942088.67168582
500,Hillsboro Police Department,local_police,OR,OR03403,5,OR03403,0,0,38658741.0,640,640,640,640,110985,4.505113303599585,34832401.67590215
501,Hillsborough County Sheriff's Office,sheriff,FL,FL02900,14,FL02900,320,588,463533760.0,0,770,588,1090,988250,1.4166455856311662,46904503.9210726
502,Hillsdale County Sheriff's Office,sheriff,MI,MI30130,1,MI30130,0,640,3184398.0,0,840,640,840,45605,2.192742023900888,6982563.31542594
503,Hinds County Sheriff's Office,sheriff,MS,MS02500,1,MS02500,0,0,20866863.0,12,480,12,480,75000,1.3333333333333333,27822484.0
505,Holly Springs Police Department,local_police,NC,NC09217,1,NC09217,0,504,7021525.0,0,640,504,640,39882,2.5073968206208312,17605749.460909683
506,Hollywood Police Department,local_police,FL,FL00605,3,FL00605,120,0,103983015.0,480,770,480,890,154611,1.9403535324136056,67254603.48875564
507,Homedale Police Department,local_police,ID,ID03701,1,ID03701,0,0,425464.0,675,460,675,460,2830,35.3356890459364,15034063.604240283
508,Homestead Police Department,local_police,FL,FL01305,2,FL01305,0,480,27385683.0,0,770,480,770,69292,2.8863360849737343,39522142.527275875
509,Honolulu Police Department,local_police,HI,HI00200,23,HI00200,1022,480,302201305.0,0,0,480,1022,963826,2.386322842504767,31354342.485054355
510,Hoover Police Department,local_police,AL,AL00112,2,AL00112,0,0,26819282.0,480,480,480,480,85959,2.326690631580172,31200086.08755337
511,Hopewell Police Department,local_police,VA,VA11300,3,VA11300,0,0,7691792.0,432,1040,432,1040,22375,13.40782122905028,34376724.02234637
512,Horry County Police Department,local_police,SC,SC02604,6,SC02604,0,0,24928508.0,343,560,343,560,276534,2.1697151164052157,9014626.77283806
513,Houma Police Department,local_police,LA,LA05501,5,LA05501,100,160,10487009.0,640,496,800,596,32467,15.40025256414205,32300517.448486153
514,Houston County Sheriff's Office,sheriff,GA,GA07600,5,GA07600,20,0,30725927.0,0,411,0,431,160250,3.1201248049921997,19173745.397815913
515,Houston Police Department,local_police,TX,TXHPD00,70,TXHPD00,409,440,945431647.0,80,696,520,1105,2316120,3.022295908674853,40819631.40942611
516,Howard County Police Department,local_police,MD,MD01401,3,MD01401,482,320,124224795.0,240,750,560,1232,328200,0.9140767824497258,37850333.6380256
518,Huntington Beach Police Department,local_police,CA,CA03010,5,CA03010,0,800,81563527.0,0,664,800,664,198246,2.5221189834851647,41142583.96134096
519,Huntsville Police Department,local_police,AL,AL04701,10,AL04701,0,160,50138599.0,0,560,160,560,202960,4.927079227433977,24703684.9625542
521,Iberia Parish Sheriff's Deputy,sheriff,LA,LA02300,2,LA02300,11,0,14882355.0,0,496,0,507,73000,2.73972602739726,20386787.671232875
522,Iberville Parish Sheriff's Office,sheriff,LA,LA02400,1,LA02400,0,400,16235146.0,0,400,400,400,32822,3.0467369447321917,49464219.12132106
523,Imperial County Sheriff's Department,sheriff,CA,CA01300,2,CA01300,180,160,37000000.0,480,900,640,1080,43353,4.613290891057136,85345881.484557
524,Independence Police Department,local_police,MO,MO04806,10,MO04806,120,560,32153547.0,0,600,560,720,116774,8.563550105331666,27534851.079863667
525,Indianapolis Metropolitan Police Department,local_police,IN,INIPD00,21,INIPD00,0,0,233043194.0,765,918,765,918,880749,2.3843342427865375,26459660.3572641
526,Indian River County Sheriff's Office,sheriff,FL,FL03100,6,FL03100,0,0,55200000.0,480,848,480,848,159923,3.751805556424029,34516611.11910107
527,Inglewood Police Department,local_police,CA,CA01933,4,CA01933,0,120,72784321.0,600,880,720,880,107203,3.7312388645840135,67893921.81188959
531,Iron County Sheriff's Office,sheriff,MI,MI36136,1,MI36136,0,0,1547599.0,0,800,0,800,13138,7.6115086010047195,11779563.099406302
532,Irving Police Department,local_police,TX,TX05715,7,TX05715,300,0,70698309.0,160,696,160,996,240916,2.905577047601654,29345626.27637849
533,Irvington Police Department,local_police,NJ,NJ00709,1,NJ00709,0,80,14000000.0,0,1500,80,1500,54226,1.844133810349279,25817873.344889905
535,Island County Sheriff's Department,sheriff,WA,WA01500,2,WA01500,0,100,10200000.0,480,720,580,720,61000,3.278688524590164,16721311.475409836
538,Jackson County Sheriff's Department,sheriff,OH,OH04000,2,OH04000,0,320,2769381.0,0,737,320,737,32413,6.170363742942647,8544044.056397125
539,Jackson County Sheriff's Office,sheriff,AL,AL03900,1,AL03900,0,0,4921563.0,420,560,420,560,53000,1.8867924528301885,9285967.9245283
541,Jackson County Sheriff's Office,sheriff,MO,MO04800,3,MO04800,0,0,10312114.0,500,600,500,600,703011,0.42673585477325393,1466849.5941030795
542,Jackson Police Department,local_police,MI,MI38497,1,MI38497,0,560,10675846.0,0,594,560,594,32374,3.0888984987953294,32976604.68277012
544,Jackson Police Department,local_police,TN,TN05701,4,TN05701,0,40,22297226.0,640,480,680,480,67402,5.9345420017210175,33080956.05471648
545,Jacksonville Police Department,local_police,AR,AR06001,3,AR06001,160,0,6512923.0,480,522,480,682,28361,10.577906279750362,22964363.033743523
546,Jacksonville Police Department,local_police,NC,NC06701,1,NC06701,0,504,14863150.0,0,640,504,640,76284,1.3108908814430287,19483967.80451995
547,Jacksonville Sheriff's Office,sheriff,FL,FL01602,47,FL01602,480,571,481594597.0,0,770,571,1250,875898,5.365921602743699,54982954.2937648
549,Jasper County Sheriff's Office,sheriff,SC,SC02700,2,SC02700,0,0,4000000.0,240,467,240,467,25000,8.0,16000000.0
552,Jefferson County Sheriff's Department,sheriff,CO,CO03000,5,CO03000,225,0,114056973.0,0,556,0,781,200000,2.5,57028486.5
553,Jefferson County Sheriff's Department,sheriff,MO,MO05000,3,MO05000,0,0,18543348.0,0,800,0,800,225081,1.3328535060711477,8238522.132032468
554,Jefferson County Sheriff's Department,sheriff,MS,MS03200,1,MS03200,40,90,850000.0,150,480,240,520,7500,13.333333333333334,11333333.333333334
555,Jefferson County Sheriff's Department,sheriff,TX,TX12300,2,TX12300,30,0,45000000.0,800,696,800,726,83248,2.402460119162022,54055352.6811455
556,Jefferson County Sheriff’s Office,sheriff,TN,KY05600,1,KY05600,0,0,26052444.0,0,824,0,824,766757,0.13041941579926886,3397744.526623167
558,Jellico Police Department,local_police,TN,TN00701,1,TN00701,0,0,300000.0,0,400,0,400,2132,46.90431519699813,14071294.559099438
559,Jemison Police Department,local_police,AL,AL01403,1,AL01403,12,0,845100.0,84,560,84,572,2693,37.13330857779428,31381359.079093948
560,Jersey City Police Department,local_police,NJ,NJ00906,3,NJ00906,0,0,107579930.0,480,790,480,790,262664,1.1421435750616757,40957241.95169494
561,Johnson City Police Department,local_police,TN,TN09001,2,TN09001,14,646,15494386.0,0,480,646,494,67142,2.9787614309969914,23077039.706889875
564,Joliet Police Department,local_police,IL,IL09907,4,IL09907,0,688,58710861.0,0,560,688,560,146673,2.727154963762928,40028404.000736326
565,Jonesboro Police Department,local_police,AR,AR01601,5,AR01601,208,480,12289780.0,0,520,480,728,79859,6.261035074318486,15389348.72713157
567,Jourdanton Police Department,local_police,TX,TX00704,1,TX00704,0,440,950000.0,40,696,480,696,4436,22.542831379621283,21415689.81064022
568,Kalamazoo County Sheriff's Office,sheriff,MI,MI39139,5,MI39139,0,0,24170400.0,640,640,640,640,160000,3.125,15106500.0
569,Kalamazoo Department of Public Safety,local_police,MI,MI39499,3,MI39499,168,504,31946749.0,0,600,504,768,76009,3.9469010248786325,42030218.78988014
570,Kanawha County Sheriff's Office,sheriff,WV,WV02000,3,WV02000,0,800,15043156.0,0,800,800,800,120000,2.5,12535963.333333334
571,Kansas City Police Department,local_police,KS,KS10502,12,KS10502,0,640,60653745.0,0,560,640,560,152727,7.857156887780158,39713832.52470094
572,Kansas City Police Department,local_police,MO,MOKPD00,31,MOKPD00,500,0,225791018.0,400,600,400,1100,497159,6.235429711621433,45416258.78240161
574,Kenner Police Department,local_police,LA,LA02603,1,LA02603,176,640,18768406.0,0,496,640,672,66288,1.5085686700458605,28313429.278300747
575,Kennewick Police Department,local_police,WA,WA00301,3,WA00301,0,80,22000000.0,720,720,800,720,84515,3.5496657398095013,26030882.091936342
576,Kenosha County Sheriff's Department,sheriff,WI,WI03000,2,WI03000,0,640,40568004.0,0,720,640,720,169561,1.1795165161800178,23925315.373228513
577,Kenosha Police Department,local_police,WI,WI03001,2,WI03001,0,0,30490881.0,800,720,800,720,99570,2.008637139700713,30622557.99939741
578,Kent County Sheriff's Office,sheriff,MI,MI41141,2,MI41141,0,680,65046293.0,0,594,680,594,286685,0.6976298027451733,22689116.277447373
579,Kent Police Department,local_police,WA,WA01707,9,WA01707,960,640,48000000.0,0,720,640,1680,130676,6.887263154672626,36732070.158254005
580,Kern County Sheriff's Office,sheriff,CA,CA01500,17,CA01500,296,200,235271211.0,400,664,600,960,878744,1.9345793541691323,26773578.084174685
581,Killeen Police Department,local_police,TX,TX01404,4,TX01404,276,160,29019920.0,720,696,880,972,153991,2.5975544025300183,18845205.23926723
582,King County Sheriff's Office,sheriff,WA,WA01700,11,WA01700,0,0,201850748.0,640,720,640,720,1600000,0.6875,12615671.75
583,King Police Department,local_police,NC,NC08503,1,NC08503,0,0,2500000.0,640,640,640,640,6912,14.467592592592592,36168981.48148148
584,Kingsport Police Department,local_police,TN,TN08202,1,TN08202,40,0,12251684.0,720,480,720,520,54112,1.8480189237137787,22641343.879361324
585,Kirkland Police Department,local_police,WA,WA01708,3,WA01708,0,0,28776477.0,560,720,560,720,95431,3.1436325722249583,30154223.470360786
587,Knox County Sheriff's Department,sheriff,TN,TN04700,5,TN04700,57,360,88184235.0,0,480,360,537,470313,1.0631217933588908,18750116.411836375
589,Knoxville Police Department,local_police,TN,TN04701,6,TN04701,400,640,55630400.0,0,480,640,880,190223,3.1541927106606455,29244833.69518933
590,Labette County Sheriff's Office,sheriff,KS,KS05000,1,KS05000,40,2,2559379.0,40,560,42,600,9000,11.11111111111111,28437544.444444444
592,Lafayette Police Department,local_police,IN,IN07901,1,IN07901,320,800,19090000.0,0,600,800,920,71484,1.3989144423927031,26705276.705276705
593,Lafayette Police Department,local_police,LA,LA02803,4,LA02803,0,480,35331489.0,240,490,720,490,126535,3.1611807009918205,27922305.291026197
594,Lake Charles Police Department,local_police,LA,LA01002,5,LA01002,0,800,21000000.0,0,509,800,509,78433,6.3748677214947795,26774444.430278074
597,Lake County Sheriff's Office,sheriff,IN,IN04500,3,IN04500,0,560,43753060.0,0,600,560,600,487599,0.6152596703438686,8973164.424045168
598,Lake County Sheriff's Office,sheriff,MT,MT02400,1,MT02400,0,80,3470900.0,560,480,640,480,30013,3.3318895145436978,11564655.31602972
601,Lakeland Police Department,local_police,FL,FL05312,6,FL05312,80,0,43520229.0,800,770,800,850,115283,5.204583503205156,37750777.651518434
602,Lake Mary Police Department,local_police,FL,FL05907,1,FL05907,0,0,5603221.0,588,770,588,770,17486,5.718860802928057,32044040.94704335
603,Lakewood Police Department,local_police,CO,CO03004,13,CO03004,305,640,57181860.0,0,556,640,861,157429,8.257690768536929,36322316.726905465
604,Lakewood Police Department,local_police,WA,WA02723,5,WA02723,229,800,24075000.0,0,720,800,949,60976,8.19994752033587,39482747.31041721
605,La Mesa Police Department,local_police,CA,CA03708,1,CA03708,264,0,20632000.0,400,664,400,928,59724,1.674368762976358,34545576.317728214
607,Lancaster County Sheriff's Department,sheriff,SC,SC02900,2,SC02900,0,0,12194820.0,312,480,312,480,90000,2.2222222222222223,13549800.0
608,Lansing Police Department,local_police,IL,IL01659,1,IL01659,0,560,13894879.0,0,560,560,560,27059,3.6956280719908348,51350304.88931594
609,Lansing Police Department,local_police,MI,MI33519,4,MI33519,106,800,43165282.0,0,594,800,700,117540,3.403096818104475,36723908.456695594
611,Largo Police Department,local_police,FL,FL05208,2,FL05208,0,800,27000000.0,0,880,800,880,84681,2.36180489129793,31884366.032522056
612,Larimer County Sheriff's Department,sheriff,CO,CO03500,9,CO03500,240,500,40524291.0,0,556,500,796,70000,12.857142857142858,57891844.28571429
613,Las Cruces Police Department,local_police,NM,NM00701,14,NM00701,404,640,26524594.0,0,677,640,1081,105096,13.321153992540156,25238442.947400473
614,Las Vegas Metropolitan Police Department,local_police,NV,NV00201,64,NV00201,560,960,631964702.0,0,480,960,1040,1689845,3.787329607153319,37397791.04000663
615,Lauderhill Police Department,local_police,FL,FL00618,1,FL00618,742,70,25126705.0,672,770,742,1512,71582,1.3969992456204074,35101987.929926515
616,La Vergne Police Department,local_police,TN,TN07503,1,TN07503,0,280,8729778.0,480,420,760,420,35646,2.8053638556920832,24490203.669415925
617,Lawrence Police Department,local_police,KS,KS02301,2,KS02301,400,720,24639000.0,0,560,720,960,98448,2.0315293352836012,25027425.64602633
619,League City Police Department,local_police,TX,TX08408,6,TX08408,128,280,20715228.0,0,696,280,824,108477,5.53112641389419,19096424.126773417
620,Lee County Sheriff's Office,sheriff,FL,FL03600,6,FL03600,106,576,192713441.0,0,770,576,876,463738,1.2938340183465662,41556534.29307065
621,Lee County Sheriff's Office,sheriff,TX,TX14400,1,TX14400,0,0,3737230.0,160,618,160,618,17144,5.832944470368642,21799055.0629958
622,Lee's Summit Police Department,local_police,MO,MO04808,1,MO04808,0,640,22170138.0,0,470,640,470,101467,0.9855420974306918,21849604.30484788
623,Leon County Sheriff's Office,sheriff,FL,FL03700,2,FL03700,0,640,80108405.0,0,770,640,770,292502,0.6837560085059248,27387301.625288032
624,Leon County Sheriff's Office,sheriff,TX,TX14500,1,TX14500,0,160,3194812.0,0,1431,160,1431,15000,6.666666666666667,21298746.666666668
625,Lewis County Sheriff's Office,sheriff,WV,WV02100,1,WV02100,15,0,760000.0,160,824,160,839,16000,6.25,4750000.0
626,Lexington County Sheriff's Department,sheriff,SC,SC03200,8,SC03200,120,160,49287572.0,0,462,160,582,298750,2.677824267782427,16497932.050209206
627,Lexington Police Department,local_police,KY,KY03402,2,KY03402,544,600,79504548.0,0,800,600,1344,324735,0.6158868000061589,24482900.82682803
628,Lincoln County Sheriff's Department,sheriff,MO,MO05700,1,MO05700,0,144,6321865.0,0,600,144,600,59013,1.694541880602579,10712665.006015623
629,Lincoln County Sheriff's Office,sheriff,MS,MS04300,1,MS04300,0,0,3428000.0,0,480,0,480,22000,4.545454545454546,15581818.181818182
630,Lincoln County Sheriff's Office,sheriff,NC,NC05500,3,NC05500,0,516,15665598.0,0,640,516,640,86111,3.4838754630651136,18192330.82881397
631,Lincoln Police Department,local_police,NE,NB05501,3,NB05501,200,240,55158134.0,0,600,240,800,290505,1.0326844632622503,18986982.668112423
633,Lino Lakes Police Department,local_police,MN,MN00207,1,MN00207,40,640,3976112.0,0,0,640,40,22427,4.458911133901101,17729130.066437777
634,Little Egg Harbor Police Department,local_police,NJ,NJ01516,2,NJ01516,0,0,4500000.0,400,600,400,600,22007,9.088017448993503,20448039.26023538
635,Little Rock Police Department,local_police,AR,AR06002,7,AR06002,0,0,77096919.0,480,920,480,920,197866,3.537747768691943,38964207.59503906
637,Livingston Parish Sheriff's Office,sheriff,LA,LA03200,2,LA03200,40,0,31740000.0,560,400,560,440,121365,1.647921558933795,26152515.140279327
638,Livingston Police Department,local_police,MT,MT03401,1,MT03401,0,640,1687184.0,0,508,640,508,7898,12.661433274246646,21362167.637376554
639,Livonia Police Department,local_police,MI,MI82538,1,MI82538,0,800,24500000.0,0,680,800,680,93189,1.0730880254107245,26290656.622562747
640,Lombard Police Department,local_police,IL,IL02213,1,IL02213,0,0,14379913.0,560,560,560,560,43961,2.274743522667819,32710613.95327677
641,Long Beach Police Department,local_police,CA,CA01941,22,CA01941,800,0,244095709.0,800,664,800,1464,454681,4.8385571422601785,53685047.098955095
642,Longmont Police Department,local_police,CO,CO00704,2,CO00704,80,800,38000000.0,0,556,800,636,98445,2.031591243841739,38600233.63299304
643,Longview Police Department,local_police,TX,TX09205,4,TX09205,135,680,20827033.0,0,696,680,831,81728,4.894283476898982,25483350.87118246
644,Lonoke County Sheriff's Office,sheriff,AR,AR04300,4,AR04300,0,480,4200000.0,0,522,480,522,73309,5.456355972663657,5729173.771296839
645,Lorain Police Department,local_police,OH,OH04705,2,OH04705,0,640,16464045.0,0,767,640,767,63872,3.1312625250501003,25776623.55961924
646,Los Angeles County Sheriff's Department,sheriff,CA,CA01900,100,CA01900,216,960,3548808000.0,0,664,960,880,10441080,0.9577553279928896,33988897.70023791
647,Los Angeles Police Department,local_police,CA,CA01942,122,CA01942,0,2080,1733838124.0,0,912,2080,912,3970219,3.0728783475168497,43671095.32244947
650,Louisville Metro Police Department,local_police,KY,KY05680,25,KY05680,250,800,186728500.0,0,800,800,1050,682986,3.6603971384479332,27340018.682666995
651,Lovejoy Police Department,local_police,GA,GA12600,1,GA12600,0,0,18290282.0,480,440,480,440,66703,1.4991829452948142,27420478.83903273
652,Spalding County Sheriff's Office,sheriff,GA,GA12600,2,GA12600,0,0,18290282.0,480,440,480,440,66703,2.9983658905896284,27420478.83903273
653,Loveland Police Department,local_police,CO,CO03504,4,CO03504,124,640,24457482.0,0,556,640,680,83517,4.789444065280123,29284435.504148856
654,Lowell Police Department,local_police,MA,MA00926,1,MA00926,40,0,28661086.0,560,797,560,837,110904,0.9016807328860996,25843149.02979153
655,Lowndes County Sheriff's Office,sheriff,GA,GA09200,4,GA09200,0,0,20471242.0,0,440,0,440,117406,3.4069809038720336,17436282.643135782
657,Lubbock Police Department,local_police,TX,TX15202,4,TX15202,347,600,69566086.0,0,696,600,1043,262611,1.5231654424224421,26490164.539946917
658,Lumberton Police Department,local_police,MS,NC07801,1,NC07801,44,0,7932050.0,672,640,672,684,20239,4.940955580809329,39191906.714758635
659,Lumberton Police Department,local_police,NC,NC07801,1,NC07801,44,0,7932050.0,672,640,672,684,20239,4.940955580809329,39191906.714758635
660,Lynchburg Police Department,local_police,VA,VA11400,2,VA11400,400,548,17112968.0,100,480,648,880,81561,2.4521523767486912,20981802.57721215
661,Lynn Police Department,local_police,MA,MA00514,5,MA00514,0,0,20460402.0,0,497,0,497,94539,5.2888226023122735,21642287.30999905
662,Lynwood Police Department,local_police,WA,WA03104,2,WA03104,0,0,21900000.0,660,720,660,720,39042,5.122688386865427,56093437.836176425
663,Madison County Sheriff's Office,sheriff,AL,AL04700,2,AL04700,40,400,30000000.0,0,560,400,600,130000,1.5384615384615383,23076923.076923076
665,Madison Police Department,local_police,WI,WI01301,3,WI01301,222,432,81558996.0,0,720,432,942,263094,1.140276859221419,30999945.26671076
668,Manchester Police Department,local_police,NH,NH00634,3,NH00634,280,384,25285675.0,0,640,384,920,112546,2.665576741954401,22466969.061539285
670,Mandan Police Department,local_police,ND,ND03002,1,ND03002,0,450,4727100.0,0,500,450,500,22857,4.3750273439209,20681191.757448483
671,Mansfield Police Department,local_police,OH,OH07001,4,OH07001,80,0,12599809.0,560,800,560,880,46125,8.67208672086721,27316659.078590788
673,Margate Police Department,local_police,FL,FL00621,2,FL00621,0,644,21755868.0,0,660,644,660,58734,3.405182688051214,37041352.5385637
675,Marietta Police Department,local_police,GA,GA03303,1,GA03303,0,0,17061168.0,0,408,0,408,60786,1.6451156516303098,28067594.51189419
676,Marina Police Department,local_police,CA,CA02712,1,CA02712,200,0,5860142.0,800,664,800,864,21836,4.5795933321121085,26837067.228430115
679,Marion Police Department,local_police,OH,OH05101,2,OH05101,0,560,6874104.0,0,740,560,740,35516,5.631264782070053,19354949.881743442
680,Marion Police Department,local_police,SC,SC03401,1,SC03401,0,0,1651561.0,200,480,200,480,6200,16.129032258064516,26638080.64516129
681,Marshall County Sheriff's Office,sheriff,AL,AL05000,3,AL05000,0,0,2900000.0,240,560,240,560,97000,3.0927835051546393,2989690.7216494847
682,Martin County Sheriff's Office,sheriff,FL,FL04300,3,FL04300,0,0,70792993.0,560,770,560,770,161000,1.8633540372670807,43970803.10559006
683,Marysville Police Department,local_police,WA,WA03105,1,WA03105,0,640,19992904.0,24,720,664,720,71392,1.400717167189601,28004403.854773644
685,Maui Police Department,local_police,HI,HI00500,4,HI00500,0,0,42000000.0,640,1096,640,1096,167902,2.382342080499339,25014591.84524306
687,McDowell County Sheriff's Office,sheriff,NC,NC05600,1,NC05600,24,500,6522744.0,0,640,500,664,45756,2.185505726025002,14255494.361395227
689,McHenry County Sheriff's Office,sheriff,IL,IL05600,2,IL05600,0,560,36288536.0,0,560,560,560,90000,2.2222222222222223,40320595.55555555
690,McKinney Police Department,local_police,TX,TX04305,3,TX04305,160,600,39699073.0,0,1082,600,1242,208272,1.4404240608435122,19061166.647461012
692,Mebane Police Department,local_police,NC,NC00104,1,NC00104,0,480,4000000.0,0,640,480,640,16732,5.976571838393498,23906287.35357399
693,Medford Police Department,local_police,OR,OR01504,4,OR01504,0,0,25005500.0,800,640,800,640,83412,4.795473073418693,29978300.48434278
695,Melbourne Police Department,local_police,FL,FL00507,3,FL00507,0,0,24580468.0,320,770,320,770,83376,3.598157743235464,29481467.08885051
696,Memphis Police Department,local_police,TN,TNMPD00,17,TNMPD00,480,640,272780015.0,0,480,640,960,649705,2.6165721365850656,41985210.98036802
698,Menomonie Police Department,local_police,WI,WI01701,1,WI01701,0,0,2726826.0,696,720,696,720,16599,6.024459304777396,16427652.268208928
699,Merced County Sheriff's Department,sheriff,CA,CA02400,7,CA02400,56,240,33983322.0,400,664,640,720,101416,6.902263942573164,33508836.869921908
701,Meridian Police Department,local_police,ID,ID00103,3,ID00103,0,0,23428263.0,140,140,140,140,121182,2.4756151903748083,19333121.255632028
702,Mesa County Sheriff's Department,sheriff,AZ,CO03900,2,CO03900,0,0,31218196.0,640,556,640,556,71607,2.79302302847487,43596570.16772103
703,Mesa County Sheriff's Office,sheriff,CO,CO03900,2,CO03900,0,0,31218196.0,640,556,640,556,71607,2.79302302847487,43596570.16772103
704,Mesa Police Department,local_police,AZ,AZ00717,31,AZ00717,293,760,198152493.0,0,583,760,876,528159,5.869444618003291,37517583.34138016
705,Mesquite Police Department,local_police,TX,TX05718,6,TX05718,351,520,39693480.0,160,696,680,1047,138916,4.319156900573009,28573728.008292783
706,Metropolitan Police Department,local_police,DC,DCMPD00,18,DCMPD00,0,0,559526918.0,560,890,560,890,712816,2.525195842966488,78495280.40896949
707,Miami Beach Police Department,local_police,FL,FL01307,5,FL01307,313,180,115174000.0,0,844,180,1157,87726,5.6995645532681305,131288329.57162072
708,Miami-Dade Police Department,local_police,FL,FL01300,44,FL01300,640,680,591686455.0,0,960,680,1600,1278492,3.4415545814913195,46280027.95480926
709,Miami Gardens Police Department,local_police,FL,FL01397,2,FL01397,0,168,37038121.0,800,788,968,788,109131,1.8326598308454976,33939138.28334754
710,Miami Police Department,local_police,FL,FL01306,6,FL01306,230,800,265621000.0,0,770,800,1000,471525,1.2724669953873071,56332325.96362865
711,Miami Township Police Department (Montgomery Co.),local_police,OH,OH05707,2,OH05707,16,0,6823507.0,480,737,480,753,50908,3.9286556140488726,13403604.541525891
713,Middletown Police Department,local_police,NY,NY03501,1,NY03501,16,560,9521717.0,160,699,720,715,28023,3.5684973057845344,33978221.4609428
718,Mille Lacs County Sheriff's Office,sheriff,MN,MN04800,1,MN04800,160,160,7000000.0,160,160,320,320,26500,3.773584905660377,26415094.33962264
721,Milwaukee Police Department,local_police,WI,WIMPD00,18,WIMPD00,320,560,298922696.0,0,720,560,1040,589067,3.055679574649403,50745109.80924071
722,Minneapolis Police Department,local_police,MN,MN02711,11,MN02711,600,960,179849642.0,0,0,960,600,433111,2.5397646330848214,41525069.093142405
723,Minnehaha County Sheriff's Office,sheriff,SD,SD04900,2,SD04900,0,520,6513588.0,0,520,520,520,29242,6.839477463921756,22274769.16763559
725,Miramar Police Department,local_police,FL,FL00622,2,FL00622,0,120,54004383.0,560,770,680,770,141150,1.4169323414806942,38260278.4272051
726,Mishawaka Police Department,local_police,IN,IN07101,1,IN07101,0,624,12180000.0,24,600,648,600,50312,1.9875973922722212,24208936.237875655
727,Mission Police Department,local_police,TX,TX10810,4,TX10810,0,320,16739914.0,160,696,480,696,84496,4.7339519030486645,19811486.934292745
729,Missoula Police Department,local_police,MT,MT03201,5,MT03201,0,680,18245121.0,0,480,680,480,76848,6.506350197793045,23741829.32542161
730,Missouri City Police Department,local_police,TX,TX07901,3,TX07901,0,160,14418401.0,0,700,160,700,76643,3.9142517907701944,18812417.31143092
731,Mobile County Sheriff's Department,sheriff,AL,AL00200,5,AL00200,0,0,50275505.0,672,560,672,560,413210,1.2100384792236392,12167059.122480094
732,Mobile Police Department,local_police,AL,AL00201,6,AL00201,324,480,57938351.0,0,520,480,844,187746,3.195807101083379,30859965.59181021
734,Modesto Police Department,local_police,CA,CA05002,9,CA05002,0,0,67073643.0,400,664,400,664,215666,4.173119545964593,31100703.40248347
735,Mohave County Sheriff's Deputy,sheriff,AZ,AZ00800,6,AZ00800,212,480,26925425.0,0,585,480,797,100000,6.0,26925425.0
736,Monongahela Police Department,local_police,PA,PA06303,1,PA06303,12,0,1068365.0,0,919,0,931,4090,24.449877750611247,26121393.643031787
737,Monroe County Sheriff's Department,sheriff,IL,IL06700,1,IL06700,0,504,3646860.0,0,560,504,560,12218,8.18464560484531,29848256.670486167
739,Monroe County Sheriff's Office,sheriff,NY,NY02700,1,NY02700,363,400,153114852.0,160,539,560,902,254446,0.3930106977511928,60175774.820590615
741,Montesano Police Department,local_police,WA,WA01405,1,WA01405,0,0,1262567.0,528,720,528,720,4074,24.54590083456063,30990844.37898871
742,Montgomery County Police Department,local_police,MD,MD01604,10,MD01604,204,320,280038331.0,240,750,560,954,894817,1.1175469397653375,31295597.982604265
743,Montgomery County Sheriff's Office,sheriff,OH,OH05700,4,OH05700,0,16,59865655.0,640,940,656,940,61483,6.50586340939772,97369443.58603191
745,Montgomery County Sheriff's Office,sheriff,VA,VA06000,2,VA06000,0,0,15003161.0,100,800,100,800,100313,1.9937595326627653,14956347.631912114
746,Montgomery Police Department,local_police,AL,AL00301,5,AL00301,0,0,49400000.0,240,560,240,560,196268,2.547537041188579,25169665.96694316
749,Morrill County Sheriff's Office,sheriff,NE,NB06200,1,NB06200,0,0,670000.0,22,700,22,700,5042,19.833399444664817,13288377.627925426
750,Morristown Police Department,local_police,TN,TN03201,3,TN03201,40,640,9017097.0,0,480,640,520,30275,9.90916597853014,29783970.27250206
751,Mount Juliet Police Department,local_police,TN,TN09503,1,TN09503,0,560,5595477.0,0,490,560,490,38526,2.595649691117687,14523898.146706121
752,Mount Pleasant Township Police Department,local_police,PA,PA06340,1,PA06340,0,200,412000.0,0,919,200,919,3532,28.312570781426956,11664779.161947906
753,Multnomah County Sheriff's Office,sheriff,OR,OR02600,1,OR02600,0,0,159242318.0,640,640,640,640,55820,1.7914725904693658,285278247.9398065
754,Muncie Police Department,local_police,IN,IN01801,7,IN01801,0,800,10994952.0,24,615,824,615,67523,10.366837966322587,16283269.404499209
755,Murrieta Police Department,local_police,CA,CA03342,1,CA03342,0,0,27000000.0,400,264,400,264,116522,0.8582070338648496,23171589.914350938
756,Muscle Shoals Police Department,local_police,AL,AL02003,1,AL02003,12,0,3500000.0,480,560,480,572,14877,6.7217853061773205,23526248.57162062
757,Myrtle Beach Police Department,local_police,SC,SC02606,4,SC02606,40,0,33228248.0,432,469,432,509,35555,11.250175783996626,93455907.74855858
759,Napa County Sheriff's Office,sheriff,CA,CA02800,2,CA02800,0,0,36717983.0,400,664,400,664,58670,3.4088972217487643,62583915.11845918
760,Naperville Police Department,local_police,IL,IL02214,1,IL02214,0,800,44143885.0,0,560,800,560,147986,0.6757395969889044,29829771.059424542
761,Nashville Police Department,local_police,TN,TN01901,14,TN01901,531,705,228155600.0,400,480,1105,1011,671295,2.0855212685927946,33987382.59632501
763,Nassau County Sheriff's Office,sheriff,FL,FL04500,7,FL04500,200,588,26764511.0,0,770,588,970,76261,9.179003684714337,35095935.01265391
764,Natrona County Sheriff's Department,sheriff,WY,WY01300,1,WY01300,40,0,15911348.0,576,605,576,645,14581,6.858240175570948,109123846.10109046
765,Nederland Police Department,local_police,TX,TX12305,1,TX12305,0,640,4100311.0,0,696,640,696,17184,5.819366852886406,23861213.919925515
767,New Albany Police Department,local_police,IN,IN02201,1,IN02201,0,0,9000000.0,800,800,800,800,36874,2.711937950859684,24407441.557737157
768,Newark Police Department,local_police,NJ,NJNPD00,10,NJNPD00,40,640,228428160.0,0,880,640,920,282520,3.539572419651706,80853801.5007787
769,New Berlin Police Department,local_police,WI,WI06804,1,WI06804,0,800,9758130.0,0,720,800,720,39812,2.511805485783181,24510524.464985434
770,New Boston Police Department,local_police,NH,NH00648,1,NH00648,8,0,1251189.0,480,640,480,648,5941,16.8321831341525,21060242.383437134
771,New Britain Police Department,local_police,CT,CT00089,2,CT00089,8,0,18012018.0,336,1340,336,1348,72198,2.7701598382226655,24948084.43447187
772,New Castle County Police Department,local_police,DE,DE00203,3,DE00203,426,704,68096399.0,0,584,704,1010,419636,0.7149052988780752,16227492.159871887
773,New Castle Police Department,local_police,IN,IN03302,2,IN03302,24,480,1980280.0,0,650,480,674,17106,11.6918040453642,11576522.857476909
774,New Hanover County Sheriff's Office,sheriff,NC,NC06500,3,NC06500,0,336,53598395.0,0,640,336,640,127997,2.343804932928115,41874727.53267655
775,New London Police Department,local_police,WI,WI06902,1,WI06902,0,480,2220891.0,0,720,480,720,7065,14.154281670205236,31435116.772823777
777,New Milford Police Department,local_police,CT,CT00096,1,CT00096,0,0,5057235.0,560,1340,560,1340,26683,3.7477045309747776,18953022.52370423
778,New Orleans Police Department,local_police,LA,LANPD00,9,LANPD00,464,0,212420440.0,800,496,800,960,389476,2.310797070936335,54540058.95100083
779,Newport Beach Police Department,local_police,CA,CA03014,1,CA03014,320,500,65793597.0,400,664,900,984,86834,1.151622636294539,75769395.62844047
780,Newport News Police Department,local_police,VA,VA11600,5,VA11600,480,380,50649407.0,100,640,480,1120,179062,2.7923289140074385,28285960.72868615
781,New Rochelle Police Department,local_police,NY,NY05904,1,NY05904,80,32,38330539.0,160,840,192,920,80973,1.2349795610882641,47337432.230496585
782,Newton County Sheriff's Office,sheriff,GA,GA10700,3,GA10700,100,100,12668560.0,480,408,580,508,115000,2.608695652173913,11016139.130434783
783,Newton Police Department,local_police,KS,KS04001,2,KS04001,40,40,5100000.0,588,568,628,608,18744,10.670081092616304,27208706.786171574
785,New York Police Department,local_police,NY,NY03030,64,NY03030,0,0,6000000000.0,0,860,0,860,8253213,0.7754555710606282,72698959.7869339
787,Nogales Police Department,local_police,AZ,AZ01201,2,AZ01201,0,0,6000000.0,180,720,180,720,20107,9.946784701845129,29840354.105535384
788,Norfolk Police Department,local_police,VA,VA11700,9,VA11700,1000,600,75717773.0,100,480,700,1480,242803,3.7067087309464872,31184858.918547135
789,Norman Police Department,local_police,OK,OK01402,1,OK01402,413,600,31064148.0,0,600,600,1013,125762,0.7951527488430528,24700742.67266742
790,Northampton County Sheriff's Office,sheriff,NC,NC06600,1,NC06600,0,0,4293996.0,504,640,504,640,22086,4.527755139002083,19442162.455854386
791,North Bend Police Department,local_police,OR,OR00606,1,OR00606,0,800,3876231.0,50,640,850,640,9744,10.262725779967159,39780695.81280788
792,North Bergen Township Police Department,local_police,NJ,NJ00908,1,NJ00908,0,192,14030593.0,0,960,192,960,59859,1.6705925591807416,23439404.2666934
794,North Charleston Police Department,local_police,SC,SC01008,5,SC01008,0,0,32311150.0,360,463,360,463,118752,4.210455402856374,27208931.218000542
797,North Little Rock Police Department,local_police,AR,AR06003,4,AR06003,80,800,23338228.0,0,589,800,669,66276,6.03536725209729,35213694.24829501
798,North Miami Beach Police Department,local_police,FL,FL01310,1,FL01310,74,160,25522938.0,800,770,960,844,42444,2.3560456130430687,60133206.106870234
799,North Miami Police Department,local_police,FL,FL01318,1,FL01318,0,560,27990029.0,0,770,560,770,62247,1.6065031246485775,44966069.0475043
800,North Port Police Department,local_police,FL,FL05803,2,FL05803,0,0,17777900.0,640,770,640,770,73738,2.71230573110201,24109550.028479207
801,North Riverside Police Department,local_police,IL,IL01678,1,IL01678,0,0,8289466.0,560,480,560,480,6346,15.75795776867318,130625055.15285219
802,Nye County Sheriff's Office,sheriff,NV,NV01200,5,NV01200,160,0,19839553.0,560,480,560,640,49197,10.163221334634226,40326753.66384129
804,Oak Forest Police Department,local_police,IL,IL01679,1,IL01679,0,0,7777710.0,384,560,384,560,26884,3.7196845707484,28930627.88275554
805,Oakland County Sheriff's Office,sheriff,MI,MI63163,3,MI63163,128,560,163323596.0,0,594,560,722,337268,0.8895003380101285,48425464.61567655
806,Oakland Police Department,local_police,CA,CA00109,9,CA00109,340,0,317032689.0,640,660,640,1000,424891,2.118190312338929,74615063.39272895
807,Ocala Police Department,local_police,FL,FL04201,1,FL04201,0,800,7753846.0,0,770,800,770,61669,1.6215602652872596,12573328.576756556
808,Oceanside Police Department,local_police,CA,CA03710,1,CA03710,264,480,58609026.0,480,664,960,928,174648,0.5725802757546608,33558372.268792085
809,Odessa Police Department,local_police,TX,TX06802,6,TX06802,194,644,28138120.0,0,696,644,890,125413,4.784193026241299,22436366.24592347
810,O'Fallon Police Department,local_police,MO,MO09201,3,MO09201,0,0,13925453.0,140,600,140,600,89769,3.3419109046552817,15512541.07765487
811,Ogden Police Department,local_police,UT,UT02901,8,UT02901,480,560,20075075.0,0,584,560,1064,87387,9.15467975785872,22972610.342499457
814,Oklahoma City Police Department,local_police,OK,OK05506,40,OK05506,497,720,199753347.0,0,583,720,1080,662314,6.0394314479234925,30159916.142494343
816,Olathe Police Department,local_police,KS,KS04605,3,KS04605,0,0,29067583.0,600,660,600,660,141665,2.1176719726114426,20518535.27688561
817,Old Bridge Police Department,local_police,NJ,NJ01209,3,NJ01209,240,480,13394370.0,0,550,480,790,65414,4.586174213471122,20476304.766563732
818,Old Saybrook Police Department,local_police,CT,CT00106,1,CT00106,0,0,4894257.0,400,1040,400,1040,10028,9.97207818109294,48805913.44236139
819,Omaha Police Department,local_police,NE,NB02802,13,NB02802,814,640,164729279.0,600,626,1240,1440,478393,2.717431066090014,34433881.557631485
820,Onalaska Police Department,local_police,TX,TX18708,1,TX18708,0,0,574836.0,372,698,372,698,3167,31.57562361856647,18150805.178402275
822,Onslow County Sheriff's Department,sheriff,NC,NC06700,3,NC06700,0,0,20252760.0,480,640,480,640,124913,2.401671563408132,16213492.590843227
823,Ontario Police Department,local_police,CA,CA03607,9,CA03607,256,160,99006979.0,400,664,560,920,183393,4.907493742945477,53986236.66115937
824,Orangeburg County Sheriff's Office,sheriff,SC,SC03800,1,SC03800,9,0,7300000.0,525,530,525,539,92029,1.086614002108031,7932282.215388627
825,Orange County Sheriff's Department,sheriff,CA,CA03000,10,CA03000,320,160,753827208.0,400,664,560,984,700000,1.4285714285714286,107689601.14285715
826,Orange County Sheriff's Office,sheriff,FL,FL04800,14,FL04800,360,560,266837506.0,0,770,560,1130,893300,1.5672226575618493,29870984.663606852
827,Orange County Sheriff's Office,sheriff,NC,NC06800,2,NC06800,24,24,12983803.0,432,608,456,632,148476,1.3470190468493224,8744714.970769687
829,Orange Police Department,local_police,NJ,NJ00717,1,NJ00717,12,0,15127911.0,160,880,160,892,30516,3.2769694586446456,49573702.32009438
830,Oregon City Police Department,local_police,OR,OR00307,1,OR00307,0,680,12050004.0,0,400,680,400,38026,2.62977962446747,31688854.993951507
831,Orlando Police Department,local_police,FL,FL04804,16,FL04804,0,800,164406492.0,0,770,800,770,289457,5.527591317535938,56798243.60785886
832,Ormond Beach Police Department,local_police,FL,FL06404,1,FL06404,0,0,8900000.0,756,780,756,780,44043,2.2705083668233317,20207524.46472765
833,Oro Valley Police Department,local_police,AZ,AZ01007,1,AZ01007,120,480,17531461.0,0,585,480,705,46678,2.1423368610480313,37558295.128325984
834,Osceola County Sheriff's Department,sheriff,FL,FL04900,3,FL04900,0,0,77859764.0,640,770,640,770,390341,0.7685587729703003,19946601.561199054
835,Oshkosh Police Department,local_police,WI,WI07103,1,WI07103,0,560,13825700.0,0,720,560,720,66495,1.503872471614407,20792089.63079931
836,Ottawa County Sheriff's Department,sheriff,MI,MI70170,2,MI70170,86,600,34936781.0,0,594,600,680,291830,0.6853305006339308,11971620.806634
838,Overland Park Police Department,local_police,KS,KS04606,3,KS04606,140,480,39644150.0,0,572,480,712,197381,1.5199031315070852,20085089.243645538
839,Oxford Police Department,local_police,AL,AL01105,2,AL01105,0,0,9151911.0,624,560,624,560,21216,9.42684766214178,43136835.407239825
840,Oxnard Police Department,local_police,CA,CA05604,4,CA05604,230,200,58000000.0,400,664,600,894,207945,1.923585563490346,27891990.670610018
842,Palm Bay Police Department,local_police,FL,FL00512,5,FL00512,0,0,22437189.0,0,770,0,770,116932,4.275989463961961,19188236.752984643
843,Palm Beach County Sheriff's Department,sheriff,FL,FL05000,9,FL05000,0,440,725885630.0,520,770,960,770,1466494,0.6137086138777247,49498029.31345099
844,Palm Beach Gardens Police Department,local_police,FL,FL05026,1,FL05026,0,656,6556893.0,0,770,656,770,58210,1.7179178835251676,11264203.745060988
845,Panama City Police Department,local_police,FL,FL00301,1,FL00301,0,0,12148812.0,520,770,520,770,33734,2.964368293116737,36013553.09183613
846,Paradise Police Department,local_police,CA,CA00405,1,CA00405,265,320,4433851.0,480,664,800,929,4329,23.100023100023098,102422060.52206051
847,Park Forest Police Department,local_police,IL,IL01688,2,IL01688,0,640,9422386.0,0,560,640,560,20937,9.552466924583273,45003515.30782825
848,Parma Heights Police Department,local_police,OH,OH01843,2,OH01843,0,0,5100000.0,800,765,800,765,19644,10.18122581958868,25962125.83995113
849,Parma Police Department,local_police,OH,OH01842,1,OH01842,0,800,16935270.0,0,737,800,737,77558,1.2893576420227442,21835619.794218518
850,Pasadena Police Department,local_police,CA,CA01953,6,CA01953,316,480,88714964.0,400,664,880,980,141045,4.25396150164841,62898340.24602077
851,Pasadena Police Department,local_police,TX,TX10115,6,TX10115,80,160,64500074.0,0,696,160,776,149440,4.014989293361885,43161184.42184155
852,Pasco County Sheriff's Office,sheriff,FL,FL05100,8,FL05100,0,800,142169188.0,0,770,800,770,422949,1.891481005984173,33613789.84227413
853,Pasco Police Department,local_police,WA,WA01102,4,WA01102,0,139,18972172.0,560,720,699,720,77095,5.188403917244957,24608822.880861275
854,Passaic County Sheriff's Office,sheriff,NJ,NJ01600,1,NJ01600,40,480,73460296.0,40,960,520,1000,499112,0.20035583195755663,14718198.720928371
856,Paterson Police Department,local_police,NJ,NJ01608,7,NJ01608,120,0,48581544.0,176,880,176,1000,144801,4.834220758143935,33550558.352497566
857,Paulding County Sheriff's Department,sheriff,GA,GA11000,4,GA11000,0,104,22611663.0,504,408,608,408,165000,2.4242424242424243,13704038.181818182
858,Pawtucket Police Department,local_police,RI,RI00408,2,RI00408,0,400,24388322.0,0,974,400,974,71710,2.789011295495747,34009652.76809371
859,Pearland Police Department,local_police,TX,TX02010,3,TX02010,0,800,29655498.0,0,643,800,643,123562,2.4279309172723007,24000500.15376896
860,Pell City Police Department,local_police,AL,AL05801,1,AL05801,0,0,4000000.0,24,360,24,360,14296,6.9949636261891435,27979854.504756574
861,Pembroke Pines Police Department,local_police,FL,FL00608,2,FL00608,0,0,71988281.0,560,788,560,788,174414,1.1466969394658686,41274370.75005447
862,Pemiscot County Sheriff's Department,sheriff,MO,MO07800,1,MO07800,0,0,1177180.0,240,700,240,700,10000,10.0,11771800.0
863,Pendleton Police Department,local_police,SC,SC00404,1,SC00404,0,240,339552.0,0,620,240,620,3313,30.184123151222458,10249079.384243887
864,Pensacola Police Department,local_police,FL,FL01701,2,FL01701,0,800,22609000.0,26,770,826,770,53142,3.763501561853148,42544503.40596891
866,Peoria Police Department,local_police,IL,IL07207,4,IL07207,0,800,25911032.0,0,560,800,560,109428,3.65537156851994,23678612.420952592
868,Phenix City Police Department,local_police,AL,AL05701,1,AL05701,0,0,7845565.0,576,560,576,560,36392,2.747856671795999,21558488.129259177
869,Philadelphia Police Department,local_police,PA,PAPEP00,30,PAPEP00,341,220,800477557.0,0,919,220,1260,1578487,1.9005541382349047,50711697.78401723
870,Phoenix Police Department,local_police,AZ,AZ00723,106,AZ00723,455,760,721210722.0,0,585,760,1040,1708127,6.205627567505227,42222312.62663725
871,Pickaway County Sheriff's Office,sheriff,OH,OH06500,2,OH06500,0,0,7446910.0,400,737,400,737,60000,3.3333333333333335,12411516.666666668
872,Pickens County Sheriff's Office,sheriff,SC,SC03900,2,SC03900,0,510,9381391.0,0,462,510,462,140000,1.4285714285714286,6700993.571428572
874,Pigeon Forge Police Department,local_police,TN,TN07803,1,TN07803,0,720,7844142.0,0,490,720,490,6237,16.0333493666827,125767869.16786917
878,Pinellas County Sheriff's Office,sheriff,FL,FL05200,11,FL05200,320,588,312837170.0,0,770,588,1090,397275,2.7688628783588194,78745747.90762067
880,Pitt County Sheriff's Office,sheriff,NC,NC07400,1,NC07400,0,800,158858357.0,800,676,1600,676,168148,0.5947141803649166,94475317.57737231
881,Pittsburgh Police Department,local_police,PA,PAPPD00,9,PAPPD00,366,520,104545326.0,0,919,520,1285,299226,3.007760020853803,34938583.545547515
882,Pittsfield Police Department,local_police,NH,NH00744,1,NH00744,0,0,985000.0,480,640,480,640,4143,24.137098720733768,23775042.239922762
885,Plano Police Department,local_police,TX,TX04306,4,TX04306,379,680,76857983.0,0,696,680,1075,291296,1.3731736790069209,26384839.819290344
886,Plantation Police Department,local_police,FL,FL00606,3,FL00606,680,760,42308013.0,0,1040,760,1720,96351,3.1136158420774045,43910299.84120559
887,Plymouth County Sherrif's Department,local_police,MA,MA01220,1,MA01220,0,240,11200000.0,240,800,480,800,62654,1.5960672901969548,17875953.65020589
888,Plymouth Police Department,local_police,MN,MN02717,1,MN02717,120,640,14935375.0,0,400,640,520,79635,1.2557292647705154,18754787.467821937
889,Plymouth Township Police Department,local_police,PA,PA04621,1,PA04621,0,480,8239864.0,0,960,480,960,17535,5.70287995437696,46990955.232392356
891,Polk County Sheriff's Office,sheriff,IA,IA07700,1,IA07700,0,0,65137876.0,496,627,496,627,490161,0.20401459928472482,13289077.670398094
892,Pomona Police Department,local_police,CA,CA01955,5,CA01955,0,240,54000000.0,800,1040,1040,1040,149212,3.350936921963381,36190118.75720452
893,Pope County Sheriff's Office,sheriff,MN,MN06100,1,MN06100,0,40,2110118.0,0,0,40,0,11000,9.090909090909092,19182890.90909091
895,Porterville Police Department,local_police,CA,CA05405,1,CA05405,0,320,13000000.0,400,890,720,890,58949,1.6963816180087874,22052961.034114234
897,Portland Police Department,local_police,OR,OR02602,22,OR02602,480,560,235876509.0,2000,80,2560,560,656751,3.349823601334448,35915668.03857169
898,Port Neches Police Department,local_police,TX,TX12308,2,TX12308,0,0,3843300.0,320,800,320,800,12596,15.878056525881233,30512067.322959673
899,Portsmouth Police Department,local_police,VA,VA12000,4,VA12000,240,488,33888321.0,100,760,588,1000,95094,4.206364229078596,35636655.309483245
900,Port St. Lucie Police Department,local_police,FL,FL05602,2,FL05602,0,0,49262328.0,540,860,540,860,209715,0.9536752259018191,23490130.891924754
902,Pottstown Police Department,local_police,PA,PA04622,2,PA04622,0,0,8028026.0,0,800,0,800,22580,8.857395925597874,35553702.3914969
903,Preston City Police Department,local_police,ID,ID02101,1,ID02101,0,80,900000.0,40,566,120,566,5678,17.611835153222966,15850651.63790067
904,Prince George's Police Department,local_police,MD,MD01721,10,MD01721,450,300,361900200.0,240,750,540,1200,697696,1.4332889969270284,51870757.4645691
905,Prince William County Police Department,local_police,VA,VA07503,2,VA07503,828,350,114171668.0,100,100,450,928,466085,0.429106278897626,24495889.805507578
906,Prince William County Sheriff's Department,sheriff,VA,VA07503,1,VA07503,828,350,114171668.0,100,100,450,928,466085,0.214553139448813,24495889.805507578
907,Provo Police Department,local_police,UT,UT02506,1,UT02506,80,480,18200000.0,0,542,480,622,116295,0.859882196139129,15649855.969732149
908,Pueblo County Sheriff's Office,sheriff,CO,CO05100,7,CO05100,0,120,26854202.0,640,560,760,560,55779,12.549525807203427,48143928.71869341
909,Pueblo Police Department,local_police,CO,CO05101,19,CO05101,514,600,30294053.0,0,566,600,1080,112751,16.8512917845518,26868101.391561937
910,Pulaski County Sheriff's Department,sheriff,AR,AR06000,1,AR06000,0,0,39620624.0,480,520,480,520,392680,0.2546602831822349,10089799.327696852
911,Putnam County Sheriff's Office,sheriff,FL,FL05400,2,FL05400,0,0,6599393.0,680,770,680,770,74364,2.689473401108063,8874445.968479373
912,Putnam County Sheriff's Office,sheriff,NY,NY03900,1,NY03900,248,0,17867102.0,160,539,160,787,98900,1.0111223458038423,18065826.086956523
913,Puyallup Police Department,local_police,WA,WA02701,3,WA02701,0,240,18628364.0,0,720,240,720,42569,7.047381897625032,43760398.41198994
914,Racine County Sheriff's Office,sheriff,WI,WI05200,1,WI05200,24,800,30200000.0,0,720,800,744,196311,0.5093958056349365,15383753.33017508
915,Racine Police Department,local_police,WI,WI05202,3,WI05202,0,160,29620253.0,680,720,840,720,76237,3.9350971313141914,38852857.53636686
918,Randall County Sheriff's Office,sheriff,TX,TX19100,1,TX19100,0,520,19510047.0,0,696,520,696,24766,4.037793749495276,78777545.82895906
919,Randolph County Sheriff's Office,sheriff,NC,NC07600,4,NC07600,0,0,21359091.0,462,640,462,640,97767,4.091360070371393,21846933.014207248
920,Rankin County Sheriff's Office,sheriff,MS,MS06100,3,MS06100,0,80,19626369.0,0,480,80,480,156000,1.923076923076923,12581005.769230768
921,Rapid City Police Department,local_police,SD,SD05101,9,SD05101,106,576,15648879.0,0,520,576,626,78864,11.412051125989045,19842867.468046255
924,Real County Sheriff's Office,sheriff,TX,TX19300,1,TX19300,0,0,640000.0,160,640,160,640,3700,27.027027027027028,17297297.2972973
925,Redding Police Deparment,local_police,CA,CA04502,12,CA04502,0,0,31641295.0,800,664,800,664,92456,12.979146837414554,34223084.49424591
926,Redondo Beach Police Department,local_police,CA,CA01956,2,CA01956,0,0,44433086.0,0,960,0,960,65533,3.05189751728137,67802612.4242748
927,Reno Police Department,local_police,NV,NV01601,13,NV01601,438,600,74804270.0,0,480,600,918,259290,5.013691233753712,28849654.82664198
928,Renton Police Department,local_police,WA,WA01713,4,WA01713,160,0,41868922.0,640,720,640,880,101494,3.9411196720988433,41252608.03594302
929,Rialto Police Department,local_police,CA,CA03609,6,CA03609,56,360,36832921.0,400,944,760,1000,104132,5.76191756616602,35371375.75385088
930,Richfield Police Department,local_police,MN,MN02718,1,MN02718,80,640,8498725.0,23,320,663,400,36237,2.7596103430195655,23453169.412478957
931,Richland County Sheriff's Department,sheriff,SC,SC04000,3,SC04000,255,474,39572960.0,0,510,474,765,405000,0.7407407407407408,9771101.234567901
932,Richmond County Sheriff's Office,sheriff,GA,GA12100,3,GA12100,0,0,63640800.0,540,408,540,408,204378,1.467868361565335,31138772.27490239
933,Richmond Police Department,local_police,CA,CA00710,3,CA00710,0,800,71266250.0,0,900,800,900,110038,2.7263309038695724,64765126.59263164
935,Rio Rancho Police Department,local_police,NM,NM02306,3,NM02306,0,120,16150112.0,640,675,760,675,99885,3.003453972067878,16168706.0119137
936,Riverside County Sheriff's Department,sheriff,CA,CA03300,53,CA03300,317,356,741570559.0,400,664,756,981,1475329,3.5924190468702237,50264758.504713185
937,Riverside County Sheriff's Office,sheriff,CA,CA03300,2,CA03300,317,356,741570559.0,400,664,756,981,1475329,0.13556298290076316,50264758.504713185
938,Riverside Police Department,local_police,CA,CA03313,6,CA03313,56,0,150000000.0,800,904,800,960,330786,1.8138615298108143,45346538.24527036
939,Roanoke County Police Department,local_police,VA,VA08003,2,VA08003,680,480,12850306.0,100,480,580,1160,86381,2.315323971706741,14876310.762783483
940,Roanoke Police Department,local_police,VA,VA12300,3,VA12300,24,0,22470382.0,504,1040,504,1064,99058,3.0285287407377495,22684065.900785398
941,Robeson County Sheriff's Department,sheriff,NC,NC07800,2,NC07800,24,0,10021656.0,0,640,0,664,130625,1.5311004784688995,7672081.148325359
942,Rochester Police Department,local_police,MN,MN05501,2,MN05501,292,768,30792695.0,0,48,768,340,119862,1.66858554003771,25690122.807895746
943,Rochester Police Department,local_police,NY,NY02701,7,NY02701,275,480,99557000.0,160,780,640,1055,205225,3.4108904860518945,48511146.30283835
944,Rockdale County Sheriff's Office,sheriff,GA,GA12200,1,GA12200,0,0,21148275.0,160,408,160,408,96000,1.0416666666666667,22029453.125
945,Rockford Police Department,local_police,IL,IL10104,5,IL10104,240,800,60892000.0,0,560,800,800,144835,3.452204232402389,42042324.02388925
947,Rocklin Police Department,local_police,CA,CA03104,1,CA03104,269,240,15543000.0,400,664,640,933,70159,1.4253338844624353,22153964.56619963
948,Rogers Police Department,local_police,AR,AR00402,1,AR00402,320,480,12171145.0,0,520,480,840,70522,1.4179972207254474,17258649.783046428
949,Rogersville Police Department,local_police,TN,TN03701,1,TN03701,0,0,1018403.0,160,400,160,400,4364,22.914757103574704,23336457.37855179
950,Roseville Police Department,local_police,CA,CA03105,1,CA03105,278,230,44842766.0,400,664,630,942,144725,0.6909656244601832,30984809.81171187
951,Roseville Police Department,local_police,MI,MI50713,1,MI50713,40,40,11500000.0,800,680,840,720,46535,2.148920167615773,24712581.927581392
952,Roswell Police Department,local_police,GA,GA06005,1,GA06005,72,800,20000000.0,0,408,800,480,95434,1.047844583691347,20956891.67382694
953,Round Rock Police Department,local_police,TX,TX24605,3,TX24605,118,0,32004180.0,160,696,160,814,137575,2.1806287479556605,23263078.320915863
955,Rusk County Sheriff's Department,sheriff,WI,WI05500,1,WI05500,0,0,3572386.0,576,720,576,720,11341,8.817564588660613,31499744.29062693
956,Russellville Police Department,local_police,AR,AR05801,1,AR05801,0,80,4248121.0,480,520,560,520,29364,3.4055305816646233,14467105.980111701
958,Sacramento County Sheriff's Department,sheriff,CA,CA03400,17,CA03400,226,40,556488969.0,480,730,520,956,593801,2.862911985665231,93716408.19062278
959,Sacramento Police Department,local_police,CA,CA03404,15,CA03404,252,560,147028812.0,400,664,960,916,512838,2.9249002609011034,28669640.70525195
960,Sahuarita Police Department,local_police,AZ,AZ01004,1,AZ01004,0,80,8500000.0,560,540,640,540,32327,3.093389426794939,26293810.127756983
961,Salem Police Department,local_police,OR,OR02402,8,OR02402,0,320,46944140.0,0,640,320,640,175891,4.548271372611447,26689336.00923299
962,Salinas Police Department,local_police,CA,CA02708,4,CA02708,224,190,53791203.0,640,664,830,888,154868,2.5828447452023657,34733581.501665935
963,Salisbury Police Department,local_police,NC,NC08005,3,NC08005,0,0,7324747.0,325,640,325,640,33821,8.870228556222465,21657393.33550161
964,Salt Lake City Police Department,local_police,UT,UT01803,16,UT01803,452,720,82235729.0,0,588,720,1040,204087,7.839793813422707,40294447.46603164
965,Salt Lake County Sheriff's Department,sheriff,UT,UT01800,2,UT01800,200,0,65859309.0,480,600,480,800,270827,0.7384788075044216,24317851.98669261
966,Unified Police Department of Greater Salt Lake,local_police,UT,UT01800,11,UT01800,200,0,65859309.0,480,600,480,800,270827,4.061633441274319,24317851.98669261
967,San Angelo Police Department,local_police,TX,TX22601,4,TX22601,518,440,22285766.0,160,696,600,1214,101612,3.9365429280006303,21932218.635594223
968,San Antonio Police Department,local_police,TX,TXSPD00,57,TXSPD00,720,320,483591991.0,160,696,480,1416,1567118,3.637250034777215,30858683.96636373
969,San Bernardino County Sheriff's Department,sheriff,CA,CA03600,46,CA03600,296,240,693156820.0,400,664,640,960,1171005,3.928249665885286,59193327.0993719
970,San Bernardino Police Department,local_police,CA,CA03610,16,CA03610,296,320,81404707.0,400,664,720,960,217491,7.356626251201199,37429000.28047138
971,San Diego County Sheriff's Department,sheriff,CA,CA03700,16,CA03700,264,340,967106780.0,405,664,745,928,918622,1.741739257278837,105277990.29415798
972,San Diego Police Department,local_police,CA,CA03711,36,CA03711,264,240,539262929.0,400,664,640,928,1422420,2.5308980469903406,37911652.606121965
973,Sandy Police Department,local_police,UT,UT01805,2,UT01805,0,640,15000000.0,0,840,640,840,94871,2.108125770783485,15810943.280876135
974,Sandy Springs Police Department,local_police,GA,GA06056,1,GA06056,0,0,19400000.0,480,480,480,480,109928,0.9096863401499162,17647914.998908374
975,Sanford Police Department,local_police,FL,FL05905,1,FL05905,0,720,16924942.0,0,770,720,770,61508,1.6258047733628147,27516651.492488783
976,Sanford Police Department,local_police,NC,NC05301,2,NC05301,0,160,9731418.0,0,640,160,640,30361,6.587398307038636,32052363.22914265
977,San Francisco Police Department,local_police,CA,CA03801,19,CA03801,696,240,692322316.0,400,664,640,1360,866606,2.1924611645892136,79888936.37939271
978,San Joaquin County Sheriff's Office,sheriff,CA,CA03900,5,CA03900,0,240,88618754.0,800,640,1040,640,184194,2.7145292463381003,48111639.9014083
979,San Jose Police Department,local_police,CA,CA04313,24,CA04313,490,240,464466750.0,400,664,640,1154,1013616,2.3677605720509542,45822752.40327698
980,San Juan County Sheriff's Department,sheriff,NM,NM02400,5,NM02400,467,630,12542800.0,0,678,630,1145,125043,3.9986244731812257,10030789.408443496
981,San Luis Obispo County Sheriff's Office,sheriff,CA,CA04000,5,CA04000,87,480,80777848.0,400,644,880,731,282868,1.7676089200616543,28556728.933636893
982,San Marcos Police Department,local_police,TX,TX10501,3,TX10501,246,400,16710498.0,160,696,560,942,66350,4.52147701582517,25185377.543330822
983,San Mateo County Sheriff's Office,sheriff,CA,CA04100,1,CA04100,400,352,282542533.0,400,664,752,1064,170000,0.5882352941176471,166201490.0
984,Santa Ana Police Department,local_police,CA,CA03019,13,CA03019,320,360,131568820.0,480,664,840,984,331301,3.9239241656378945,39712774.78788172
985,Santa Barbara County Sheriff's Department,sheriff,CA,CA04200,4,CA04200,60,640,143529874.0,0,664,640,724,142471,2.8075889128313833,100743220.72562136
986,Santa Barbara Police Department,local_police,CA,CA04203,1,CA04203,340,600,48000000.0,480,640,1080,980,90254,1.1079841336672058,53183238.416025884
988,Santa Clara Sheriff's Office,sheriff,CA,CA04300,1,CA04300,370,360,194404249.0,400,664,760,1034,1918880,0.052113733010923036,10131131.128575
989,Santa Cruz County Sheriff's Office,sheriff,CA,CA04400,2,CA04400,240,440,83720513.0,400,664,840,904,132080,1.5142337976983646,63386215.17262265
990,Santa Cruz Police Department,local_police,CA,CA04402,1,CA04402,140,0,31000000.0,720,1000,720,1140,64317,1.554798886763997,48198765.48968391
991,Santa Fe Police Department,local_police,NM,NM02601,5,NM02601,24,560,28248228.0,0,677,560,701,84996,5.882629770812744,33234773.401101228
993,Santa Paula Police Department,local_police,CA,CA05606,1,CA05606,236,80,7933663.0,560,664,640,900,30242,3.306659612459493,26233923.02096422
994,Santa Rosa County Sheriff's Office,sheriff,FL,FL05700,3,FL05700,0,600,47117461.0,0,770,600,770,162513,1.8460061656605933,28993041.172090847
995,Santa Rosa Police Department,local_police,CA,CA04905,1,CA04905,136,520,65750684.0,400,664,920,800,174613,0.5726950456151604,37655090.972608
998,Satsuma Police Department,local_police,AL,AL00207,1,AL00207,0,0,1313943.0,480,520,480,520,6206,16.113438607798905,21172139.864647117
999,Saugus Police Department,local_police,MA,MA00530,1,MA00530,8,200,8500000.0,0,800,200,808,28542,3.503608716978488,29780674.094317146
1000,Schenectady Police Department,local_police,NY,NY04601,2,NY04601,0,560,20297280.0,0,1080,560,1080,65231,3.0660268890558173,31116003.12734743
1001,Scottsdale Police Department,local_police,AZ,AZ00725,6,AZ00725,215,640,109110143.0,0,585,640,800,262647,2.2844350021131024,41542504.95912765
1002,Seal Beach Police Department,local_police,CA,CA03020,1,CA03020,0,0,11811300.0,560,644,560,644,23887,4.1863775275254325,49446560.89086114
1003,Seattle Police Department,local_police,WA,WASPD00,19,WASPD00,160,630,398561697.0,0,720,630,880,769714,2.46844932013709,51780492.104859725
1004,Sebastian County Sheriff's Office,sheriff,AR,AR06600,1,AR06600,24,24,11500000.0,520,520,544,544,130000,0.7692307692307692,8846153.846153846
1005,Sedgwick County Sheriff's Office,sheriff,KS,KS08700,5,KS08700,344,30,57528679.0,480,572,510,916,60000,8.333333333333334,95881131.66666667
1006,Seekonk Police Department,local_police,MA,MA00316,1,MA00316,0,0,4400000.0,480,960,480,960,15851,6.308750236578134,27758501.040943787
1007,Seguin Police Department,local_police,TX,TX09403,2,TX09403,0,640,8043792.0,0,800,640,800,30165,6.6302005635670485,26665977.125808056
1009,Seminole County Sheriff's Office,sheriff,FL,FL05900,2,FL05900,0,774,124985600.0,0,770,774,770,213465,0.9369217436113648,58550863.1391563
1012,Sevier County Sheriff's Office,sheriff,TN,TN07800,1,TN07800,0,0,14900000.0,510,494,510,494,98250,1.0178117048346056,15165394.402035622
1013,Seymour Police Department,local_police,IN,IN03602,1,IN03602,52,10,5070397.0,504,617,514,669,20096,4.976114649681529,25230876.791401275
1014,Shafter Police Department,local_police,CA,CA01507,1,CA01507,200,480,6875136.0,40,664,520,864,20739,4.8218332610058345,33150759.43873861
1015,Shakopee Police Department,local_police,MN,MN07004,1,MN07004,0,774,9000000.0,0,960,774,960,43020,2.3245002324500232,20920502.09205021
1016,Shawnee County Sheriff's Office,sheriff,KS,KS08900,3,KS08900,100,800,18871162.0,0,560,800,660,176875,1.696113074204947,10669208.197879858
1017,Shelby County Sheriff's Department,sheriff,AL,AL05900,3,AL05900,0,520,23714509.0,0,520,520,520,217702,1.378030518782556,10893105.71331453
1018,Shelby County Sheriff's Office,sheriff,IN,IN07300,2,IN07300,0,0,5600000.0,320,420,320,420,43000,4.651162790697675,13023255.813953489
1019,Shelby County Sheriff's Office,sheriff,TN,TN07900,12,TN07900,536,560,176882680.0,0,400,560,936,119541,10.038396868020177,147968211.74325126
1021,Shelbyville Police Department,local_police,TN,TN00201,1,TN00201,0,400,3031287.0,0,480,400,480,22326,4.479082683866344,13577385.11152916
1022,Shreveport Police Department,local_police,LA,LA00901,12,LA00901,140,640,59966400.0,0,400,640,540,184786,6.49399846308703,32451809.119738508
1024,Simi Valley Police Department,local_police,CA,CA05609,1,CA05609,0,0,36131593.0,800,887,800,887,125168,0.7989262431292343,28866477.85376454
1025,Sioux City Police Department,local_police,IA,IA09701,1,IA09701,80,680,22649749.0,0,640,680,720,82759,1.2083277951642721,27368321.270194177
1026,Sioux Falls Police Department,local_police,SD,SD04902,5,SD04902,360,520,38990750.0,0,520,520,880,187809,2.662279230494811,20760852.78128311
1029,Smith Township Police Department,local_police,PA,PA06332,1,PA06332,0,0,390000.0,620,16,620,16,4347,23.004370830457788,8971704.623878537
1032,Snyder Police Department,local_police,TX,TX20801,2,TX20801,0,0,2096485.0,160,696,160,696,11005,18.173557473875512,19050295.32030895
1033,Solano County Sheriff's Office,sheriff,CA,CA04800,2,CA04800,356,160,119815177.0,400,664,560,1020,19862,10.069479407914612,603238228.7785722
1034,Sonoma County Sheriff's Department,sheriff,CA,CA04900,2,CA04900,80,0,184901167.0,480,664,480,744,504000,0.3968253968253968,36686739.484126985
1037,South Milwaukee Police Department,local_police,WI,WI04114,1,WI04114,0,0,4600000.0,400,720,400,720,20673,4.837227301310889,22251245.58603009
1039,Sparks Police,local_police,NV,NV01602,12,NV01602,0,120,32000000.0,560,720,680,720,106900,11.225444340505145,29934518.241347056
1040,Spartanburg County Sheriff's Department,sheriff,SC,SC04200,8,SC04200,0,240,26443202.0,0,480,240,480,319785,2.5016808167987867,8269056.397266914
1042,Spokane County Sheriff's Department,sheriff,WA,WA03200,8,WA03200,80,640,46070029.0,0,400,640,480,275000,2.909090909090909,16752737.818181818
1043,Spokane Police Department,local_police,WA,WA03204,18,WA03204,0,800,61831752.0,0,720,800,720,222050,8.106282368835847,27845868.94843504
1044,Spotsylvania County Sheriff's Department,sheriff,VA,VA08800,1,VA08800,0,300,24267944.0,100,480,400,480,140369,0.7124080103156679,17288677.699492052
1045,Springdale Police Department,local_police,AR,AR07202,3,AR07202,0,0,18732990.0,560,520,560,520,81115,3.6984528139061825,23094359.859458793
1047,Springfield Police Department,local_police,MA,MA00718,2,MA00718,100,240,49973520.0,0,800,240,900,152646,1.3102210342884846,32738178.530718133
1048,Springfield Police Department,local_police,MO,MO03903,14,MO03903,460,520,42605053.0,0,600,520,1060,168090,8.328871437920162,25346572.074483905
1049,Stafford County Sheriff's Department,sheriff,VA,VA08900,2,VA08900,80,300,29545492.0,100,760,400,840,153392,1.3038489621362261,19261429.540002085
1050,Stamford Police Department,local_police,CT,CT00135,1,CT00135,0,80,52000000.0,400,1040,480,1040,131397,0.761052383235538,39574723.92824798
1051,Stanislaus County Sheriff's Department,sheriff,CA,CA05000,7,CA05000,106,80,153398980.0,400,664,480,770,550660,1.271201830530636,27857294.88250463
1052,St. Bernard Parish Sheriff's Department,sheriff,LA,LA04400,1,LA04400,0,0,24890000.0,540,496,540,496,50000,2.0,49780000.0
1053,St. Charles Police Department,local_police,MO,MO09203,2,MO09203,0,0,20611514.0,647,600,647,600,71761,2.787029166260225,28722445.33939048
1054,St. Cloud Police Department,local_police,MN,MN07304,1,MN07304,400,640,19200000.0,0,480,640,880,68510,1.4596409283316303,28025105.823967304
1055,Steilacoom Police Department,local_police,WA,WA02711,1,WA02711,0,0,2606721.0,560,720,560,720,6416,15.586034912718207,40628444.513715714
1058,St. John's County Sheriff's Office,sheriff,FL,FL05500,5,FL05500,0,800,82272408.0,0,160,800,160,265512,1.8831540570671004,30986323.781975955
1059,St. Johns County Sheriff's Office,sheriff,FL,FL05500,1,FL05500,0,800,82272408.0,0,160,800,160,265512,0.3766308114134201,30986323.781975955
1060,St. Joseph County (PD) Sheriff's Department,sheriff,IN,IN07100,1,IN07100,0,40,12267666.0,448,1200,488,1200,271826,0.36788239535585265,4513058.353505552
1061,St. Joseph Police Department,local_police,MO,MO01101,3,MO01101,120,560,19934161.0,0,600,560,720,74074,4.05000405000405,26911144.26114426
1062,St. Landry Parish Sheriff's Department,sheriff,LA,LA04900,1,LA04900,0,0,14299247.0,480,535,480,535,83334,1.1999904000767994,17158959.128326975
1063,St. Louis County Police Department,local_police,MO,MO09500,15,MO09500,900,640,136708269.0,0,600,640,1500,420900,3.5637918745545263,32479987.88310763
1066,St. Louis Police Department,local_police,MO,MOSPD00,28,MOSPD00,600,600,171426114.0,0,600,600,1200,297645,9.40717969393069,57594152.09393741
1067,St. Lucie County Sheriff's Office,sheriff,FL,FL05600,4,FL05600,0,800,86634607.0,0,770,800,770,328297,1.2184089406848067,26389094.935378633
1068,St. Martin Parish Sheriff's Department,sheriff,LA,LA05000,2,LA05000,75,588,14367797.0,0,496,588,571,37234,5.371434710211098,38587841.75753344
1070,Stockton Police Department,local_police,CA,CA03905,15,CA03905,664,800,135600000.0,640,664,1440,1328,312716,4.796684531651723,43362028.16613157
1071,St. Paul Police Department,local_police,MN,MN06209,11,MN06209,640,640,100637713.0,0,640,640,1280,306717,3.586367889618117,32811260.217073068
1072,St. Petersburg Police Department,local_police,FL,FL05214,6,FL05214,0,80,115000000.0,480,790,560,790,267802,2.24046123628651,42942173.69549144
1073,St. Peters Police Department,local_police,MO,MO09204,2,MO09204,0,0,14600445.0,480,600,480,600,58043,3.445721275606016,25154531.984907743
1074,Stratford Police Department,local_police,CT,CT00138,1,CT00138,0,80,10957380.0,400,880,480,880,51660,1.9357336430507164,21210569.10569106
1076,St. Tammany Parish Sheriff's Office,sheriff,LA,LA05200,7,LA05200,102,480,71207051.0,0,501,480,603,210000,3.333333333333333,33908119.52380952
1077,Suffolk County Police Department,local_police,NY,NY05100,6,NY05100,0,0,177441949.0,160,699,160,699,1468140,0.40868037108177696,12086173.593798956
1078,Suffolk County Sheriff's Office,sheriff,NY,NY05100,1,NY05100,0,0,177441949.0,160,699,160,699,1468140,0.06811339518029616,12086173.593798956
1079,Suffolk Police Department,local_police,VA,VA12700,1,VA12700,280,0,28050816.0,100,480,100,760,93913,1.0648153077848648,29868938.27265661
1080,Sugar Land Police Department,local_police,TX,TX07905,1,TX07905,240,640,21182327.0,0,618,640,858,117875,0.848356309650053,17970160.76352068
1081,Sullivan County Sheriff's Office,sheriff,TN,TN08200,5,TN08200,0,0,23878573.0,40,488,40,488,158348,3.1576022431606336,15079807.133654987
1082,Sulphur Springs Police Department,local_police,TX,TX11202,1,TX11202,0,0,3250000.0,560,728,560,728,16272,6.145526057030482,19972959.685349066
1083,Summersville Police Department,local_police,WV,WV03402,1,WV03402,0,0,1600000.0,160,640,160,640,3225,31.007751937984494,49612403.10077519
1084,Summit County Sheriff's Office,sheriff,OH,OH07700,1,OH07700,0,0,436000000.0,320,740,320,740,541013,0.18483844195980503,80589560.694475
1085,Sumner County Sheriff's Office,sheriff,TN,TN08300,1,TN08300,42,285,24147368.0,425,489,710,531,191283,0.522785610848847,12623896.5302719
1086,Sumter County Sheriff's Department,sheriff,FL,FL06000,2,FL06000,0,752,32750834.0,0,770,752,770,132420,1.5103458692040477,24732543.42244374
1087,Sumter County Sheriff's Office,sheriff,SC,SC04300,3,SC04300,0,0,11061945.0,635,462,635,462,107000,2.803738317757009,10338266.355140187
1088,Sumter Police Department,local_police,SC,SC04301,1,SC04301,100,800,10173931.0,0,462,800,562,39439,2.5355612464819086,25796625.16798093
1089,Sunnyvale Police Department,local_police,CA,CA04316,4,CA04316,0,0,98366896.0,800,1100,800,1100,151746,2.6359838150593755,64823386.4484072
1090,Sunrise Police Department,local_police,FL,FL00627,2,FL00627,0,560,49318390.0,0,770,560,770,94851,2.1085702839189886,51995645.80236371
1091,Surprise Police Department,local_police,AZ,AZ00727,3,AZ00727,0,200,28478300.0,680,585,880,585,147965,2.0275065049167034,19246646.166323118
1093,Syracuse Police Department,local_police,NY,NY03301,6,NY03301,552,288,48960741.0,160,540,448,1092,141229,4.2484192340100115,34667625.6292971
1095,Tallahassee Police Department,local_police,FL,FL03703,6,FL03703,0,320,60942296.0,720,770,1040,770,196326,3.056141315974451,31041378.11599075
1096,Tallapoosa County Sheriff's Department,sheriff,AL,AL06200,1,AL06200,0,240,4058476.0,0,520,240,520,23499,4.255500234052513,17270845.567896508
1097,Tampa Police Department,local_police,FL,FL02902,10,FL02902,480,360,162695004.0,640,770,1000,1250,407599,2.453391691343698,39915457.103672974
1098,Taney County Sheriff's Office,sheriff,MO,MO10700,1,MO10700,0,480,4579446.0,0,700,480,700,37500,2.6666666666666665,12211856.0
1099,Tangipahoa Parish Sheriff's Department,sheriff,LA,LA05300,3,LA05300,40,432,20203500.0,0,496,432,536,134758,2.226212915003191,14992430.87608899
1100,Taos County Sheriff's Department,sheriff,NM,NM02900,2,NM02900,40,250,2100000.0,0,667,250,707,45000,4.444444444444445,4666666.666666667
1101,Tarentum Borough Police Department,local_police,PA,PA00292,1,PA00292,0,0,1169941.0,160,900,160,900,4338,23.05209774089442,26969594.28307976
1103,Tate County Sheriff's Office,sheriff,MS,MS06900,2,MS06900,0,0,3750000.0,0,400,0,400,21000,9.523809523809524,17857142.85714286
1105,Taylor Police Department,local_police,MI,MI82775,1,MI82775,0,640,10200000.0,0,594,640,594,60576,1.6508188061278395,16838351.82250396
1106,Tell City Police Department,local_police,IN,IN06201,1,IN06201,16,0,1300000.0,500,300,500,316,7179,13.92951664577239,18108371.63950411
1107,Tempe Police Department,local_police,AZ,AZ00729,11,AZ00729,960,800,99092331.0,0,585,800,1545,200402,5.4889671759762875,49446777.477270685
1108,Temple Police Department,local_police,TX,TX01407,2,TX01407,257,640,19404514.0,160,643,800,900,80761,2.4764428375082033,24027084.855313826
1109,Terrebonne Parish Sheriff's Office,sheriff,LA,LA05500,5,LA05500,110,420,27051000.0,0,496,420,606,112021,4.4634488176324085,24148150.793154858
1110,Terre Haute Police Department,local_police,IN,IN08401,4,IN08401,80,80,14000000.0,600,480,680,560,60410,6.621420294653204,23174971.031286214
1111,The Colony Police Department,local_police,TX,TX06115,1,TX06115,0,800,12171023.0,0,696,800,696,45498,2.1978988087388456,26750676.95283309
1112,Thomaston Police Department,local_police,CT,CT00140,1,CT00140,0,0,1200000.0,400,1340,400,1340,7505,13.324450366422385,15989340.43970686
1113,Thornton Police Department,local_police,CO,CO00104,5,CO00104,420,800,37724908.0,0,548,800,968,148113,3.3758009087656045,25470355.741899766
1114,Thurston County Sheriff's Office,sheriff,WA,WA03400,5,WA03400,0,0,19319092.0,534,720,534,720,145300,3.4411562284927735,13296002.752924982
1116,Toms River Police Department,local_police,NJ,NJ01507,1,NJ01507,0,480,26765835.0,0,960,480,960,95339,1.0488887024197864,28074381.9423321
1118,Tooele Police Department,local_police,UT,UT02301,1,UT02301,0,0,5419556.0,504,597,504,597,37046,2.6993467580845434,14629260.918857636
1119,Topeka Police Department,local_police,KS,KS08901,8,KS08901,336,800,40191451.0,0,560,800,896,124558,6.422710705053068,32267257.82366448
1120,Torrance County Sheriff's Office,sheriff,NM,NM03000,4,NM03000,0,0,2000000.0,480,640,480,640,15461,25.871547765345063,12935773.882672532
1121,Torrance Police Department,local_police,CA,CA01972,5,CA01972,80,0,84319367.0,670,664,670,744,141553,3.532245872570698,59567347.212704785
1122,Travis County Sheriff's Office,sheriff,TX,TX22700,2,TX22700,288,0,198423870.0,720,696,720,984,282746,0.7073486450736703,70177427.79738706
1123,Trenton Police Department,local_police,MI,MI82783,1,MI82783,0,40,4612884.0,640,594,680,594,18031,5.546004104043037,25583073.59547446
1124,Trenton Police Department,local_police,NJ,NJ01111,2,NJ01111,0,0,33301459.0,0,176,0,176,82957,2.410887568258254,40143036.75398098
1128,Tucson Police Department,local_police,AZ,AZ01003,37,AZ01003,295,680,181764789.0,0,585,680,880,553571,6.683876142355723,32834955.04641681
1129,Tulare County Sheriff's Department,sheriff,CA,CA05400,11,CA05400,0,0,86933122.0,672,940,672,940,140209,7.845430749809213,62002526.228701435
1130,Tulare Police Department,local_police,CA,CA05406,2,CA05406,100,48,18476850.0,400,1020,448,1120,66797,2.9941464437025616,27661197.359162837
1131,Tularosa Police Department,local_police,NM,NM01902,1,NM01902,0,0,590000.0,540,677,540,677,3040,32.89473684210526,19407894.736842107
1135,Tupelo Police Department,local_police,MS,MS04101,2,MS04101,0,800,10964199.0,0,480,800,480,38303,5.221523118293606,28624909.27603582
1137,Union City Police Department,local_police,CA,CA00113,1,CA00113,0,0,24937059.0,384,1064,384,1064,74501,1.3422638622300374,33472113.12599831
1138,Union County Sheriff's Department,sheriff,AR,AR07000,1,AR07000,16,24,2976740.0,300,480,324,496,30000,3.3333333333333335,9922466.666666668
1139,Union County Sheriff's Department,sheriff,NC,NC09000,2,NC09000,0,480,34191115.0,0,634,480,634,239859,0.833823204465957,14254672.536782026
1140,Union Parish Sheriff's Department,sheriff,LA,LA05600,1,LA05600,0,80,3991396.0,0,640,80,640,27000,3.7037037037037033,14782948.148148147
1143,Upper Darby Police Department,local_police,PA,PA02337,2,PA02337,0,80,31189051.0,480,840,560,840,82883,2.413040068530338,37630214.881218106
1145,Utah County Sheriff's Office,sheriff,UT,UT02500,4,UT02500,0,0,52514006.0,559,104,559,104,53943,7.415234599484641,97350918.56218602
1146,Utica Police Department,local_police,NY,NY03202,1,NY03202,300,320,19202624.0,160,539,480,839,59253,1.68767826101632,32407851.079270247
1147,Vacaville Police Department,local_police,CA,CA04806,2,CA04806,160,280,39850235.0,400,664,680,824,101332,1.9737101803971104,39326407.25535862
1148,Valdosta Police Department,local_police,GA,GA09201,1,GA09201,0,0,15000000.0,600,408,600,408,56668,1.7646643608385686,26469965.41257853
1149,Valencia County Sheriff's Department,sheriff,NM,NM03200,5,NM03200,0,560,6579002.0,0,677,560,677,77071,6.487524490404951,8536287.31948463
1150,Vallejo Police Department,local_police,CA,CA04807,6,CA04807,400,480,45517060.0,800,664,1280,1064,120747,4.969067554473403,37696224.336836524
1152,Vancouver Police Department,local_police,WA,WA00603,9,WA00603,0,0,56257242.0,735,720,735,720,186192,4.833720030935808,30214639.726733696
1153,Vanderburgh County Sheriff's Office,sheriff,IN,IN08200,1,IN08200,73,800,22824489.0,0,480,800,553,180858,0.5529199703634896,12620115.781441793
1155,Ventnor Police Department,local_police,NJ,NJ00122,2,NJ00122,24,0,30816762.0,640,880,640,904,9872,20.25931928687196,312163310.37277144
1156,Ventura County Sheriff's Department,sheriff,CA,CA05600,3,CA05600,223,272,208419353.0,400,664,672,887,453000,0.662251655629139,46008687.19646799
1157,Ventura Police Department,local_police,CA,CA05608,1,CA05608,216,420,44938301.0,640,664,1060,880,107110,0.9336196433572963,41955280.55270283
1159,Vernon Parish Sheriff's Office,sheriff,LA,LA05800,2,LA05800,0,0,11601400.0,160,520,160,520,47429,4.216829365999705,24460562.103354488
1160,Victoria Police Department,local_police,TX,TX23501,1,TX23501,200,650,14184367.0,0,696,650,896,66838,1.4961548819533799,21222009.93446842
1161,Vineland Police Department,local_police,NJ,NJ00614,3,NJ00614,0,0,15467172.0,500,1100,500,1100,58615,5.118143819841338,26387736.927407663
1162,Virginia Beach Police Department,local_police,VA,VA12800,9,VA12800,560,540,102960533.0,100,480,640,1040,451231,1.994543814587207,22817699.360194664
1163,Visalia Police Department,local_police,CA,CA05407,6,CA05407,270,320,42774499.0,400,664,720,934,135007,4.444214003718326,31683171.242972583
1164,Volusia County Sheriff's Department,sheriff,FL,FL06400,15,FL06400,240,564,95024819.0,0,770,564,1010,238840,6.28035504940546,39785973.45503266
1165,Waco Police Department,local_police,TX,TX15512,6,TX15512,350,639,42369764.0,1,696,640,1046,141377,4.2439717917341575,29969347.20640557
1168,Walker County Sheriff's Office,sheriff,GA,GA14600,4,GA14600,0,200,8200000.0,0,440,200,440,69700,5.738880918220947,11764705.882352943
1170,Walton County Sheriff's Department,sheriff,GA,GA14700,6,GA14700,40,0,18000000.0,72,320,72,360,98000,6.122448979591836,18367346.93877551
1171,Walton Village Police Department,local_police,NY,NY01229,1,NY01229,100,100,393000.0,160,720,260,820,2776,36.023054755043226,14157060.518731989
1172,Warren Police Department,local_police,MI,MI50806,1,MI50806,80,800,44805423.0,0,790,800,870,132877,0.7525756903000519,33719472.143410824
1173,Warwick Police Department,local_police,RI,RI00203,1,RI00203,0,0,19825000.0,640,880,640,880,81189,1.2316939486876302,24418332.532732267
1175,Washington County Sheriff's Office,sheriff,AL,AL06500,2,AL06500,0,0,1623527.0,160,560,160,560,19000,10.526315789473685,8544878.94736842
1176,Washington County Sheriff's Office,sheriff,AR,AR07200,3,AR07200,0,520,25639819.0,0,520,520,520,37350,8.032128514056225,68647440.42838019
1177,Washington County Sheriff's Office,sheriff,MN,MN08200,2,MN08200,0,20,36000000.0,560,640,580,640,262000,0.7633587786259541,13740458.015267175
1178,Washington County Sheriff's Office,sheriff,OR,OR03400,4,OR03400,360,0,125052107.0,680,640,680,1000,267531,1.4951538326399556,46743034.26518796
1182,Washoe County Sheriff's Department,sheriff,NV,NV01600,4,NV01600,0,0,123677838.0,640,880,640,880,110491,3.6202043605361522,111934762.10732095
1183,Waterbury Police Department,local_police,CT,CT00151,1,CT00151,40,0,33449706.0,400,1340,400,1380,106826,0.9361016980884803,31312326.58716043
1185,Waukegan Police Department,local_police,IL,IL04921,3,IL04921,0,560,35280000.0,0,560,560,560,85453,3.5107017892876784,41285853.0420231
1186,Waukesha Police Department,local_police,WI,WI06805,6,WI06805,0,80,18000000.0,640,720,720,720,72376,8.290040897535095,24870122.692605283
1187,Waverly Police Department,local_police,TN,TN04301,1,TN04301,0,0,1251178.0,480,480,480,480,4118,24.283632831471586,30383147.15881496
1189,Waynesboro Police Department,local_police,MS,MS07701,1,MS07701,0,0,1200000.0,0,460,0,460,4866,20.55076037813399,24660912.453760788
1192,Wellington Police Department,local_police,KS,KS09601,1,KS09601,40,588,1598378.0,0,560,588,600,7550,13.245033112582782,21170569.536423843
1197,West New York Police Department,local_police,NJ,NJ00912,1,NJ00912,0,288,15300000.0,40,840,328,840,53132,1.8821049461717985,28796205.676428515
1198,West Palm Beach Police Department,local_police,FL,FL05008,3,FL05008,0,160,65062499.0,720,770,880,770,112782,2.6599989360004255,57688726.037842914
1199,West Sacramento Police Department,local_police,CA,CA05704,3,CA05704,0,0,21002784.0,280,664,280,664,53680,5.588673621460506,39125901.63934426
1200,West Springfield Police Department,local_police,MA,MA00721,1,MA00721,0,384,8249429.0,0,880,384,880,28397,3.521498749867944,29050353.910624363
1203,Whitehall Police Department,local_police,OH,OH02511,1,OH02511,0,680,6645525.0,0,680,680,680,18908,5.288766659614978,35146631.05563783
1204,White Oak Police Department,local_police,TX,TX09206,1,TX09206,0,600,1120000.0,0,650,600,650,6283,15.915963711602739,17825879.35699507
1205,White Pine Police Department,local_police,TN,TN04502,1,TN04502,40,0,948662.0,192,494,192,534,2634,37.96507213363706,36016021.260440394
1208,Whittier Police Department,local_police,CA,CA01976,4,CA01976,0,360,37149457.0,600,984,960,984,83194,4.8080390412770155,44654009.904560424
1209,Wichita Falls Police Department,local_police,TX,TX24305,3,TX24305,344,640,27084229.0,0,696,640,1040,105405,2.8461647929415115,25695393.007921826
1210,Wichita Police Department,local_police,KS,KS08703,14,KS08703,376,480,89740122.0,0,560,480,936,391731,3.5738810561329073,22908608.71363257
1211,Wicomico County Sheriff's Office,sheriff,MD,MD02300,1,MD02300,0,0,12994704.0,240,960,240,960,80000,1.25,16243380.0
1212,Wilburton Police Department,local_police,OK,OK03901,1,OK03901,0,0,300000.0,0,125,0,125,2567,38.955979742890534,11686793.92286716
1216,Williamson County Sheriff's Office,sheriff,TN,TN09400,1,TN09400,0,0,24655283.0,560,480,560,480,232000,0.4310344827586207,10627277.155172415
1217,Wilmington Police Department,local_police,DE,DE00206,4,DE00206,0,0,59835037.0,800,960,800,960,70376,5.683755825849721,85021935.0346709
1218,Wilmington Police Department,local_police,NC,NC06502,1,NC06502,240,0,36703021.0,672,460,672,700,124794,0.8013205763097585,29410885.940029167
1219,Wilson Police Department,local_police,NC,NC09801,1,NC09801,0,0,15566674.0,288,640,288,640,49479,2.0210594393581114,31461173.42711049
1220,Winnebago County Sheriff's Department,sheriff,IL,IL10100,1,IL10100,0,800,28526150.0,0,560,800,560,135502,0.7379964871367213,21052198.491535183
1221,Winston-Salem Police Department,local_police,NC,NC03402,3,NC03402,416,676,78167060.0,0,640,676,1056,248112,1.2091313600309537,31504747.85580705
1222,Winthrop Police Department,local_police,MA,MA01305,1,MA01305,0,0,3695264.0,150,800,150,800,18446,5.421229534858505,20032874.33589938
1225,Woodbridge Township Police Department,local_police,NJ,NJ01225,1,NJ01225,185,720,34072958.0,40,768,760,953,99430,1.0057326762546515,34268287.23725234
1226,Wood County Sheriff's Office,sheriff,WV,WV05400,1,WV05400,16,488,5794743.0,0,850,488,866,53497,1.8692636970297403,10831902.723517207
1228,Wright County Sheriff's Office,sheriff,MN,MN08600,1,MN08600,72,450,23466696.0,0,0,450,72,142505,0.7017297638679345,16467279.042840604
1230,Wyoming Police Department,local_police,MI,MI41834,2,MI41834,0,0,17161437.0,0,594,0,594,76628,2.610012006055228,22395778.305580206
1232,Yamhill County Sheriff's Department,sheriff,OR,OR03600,2,OR03600,0,630,18390408.0,50,640,680,640,42844,4.668098216786482,42924115.39538792
1233,Yonkers Police Department,local_police,NY,NY05907,1,NY05907,0,0,105296716.0,160,700,160,700,200040,0.4999000199960008,52637830.433913216
1234,York County Sheriff's Office,sheriff,SC,SC04600,2,SC04600,0,800,36759699.0,0,480,800,480,165000,1.2121212121212122,22278605.454545457
1235,York Police Department,local_police,PA,PA06702,1,PA06702,0,640,21357458.0,160,919,800,919,43907,2.2775411665565852,48642489.80800328
1237,Yuma Police Department,local_police,AZ,AZ01405,3,AZ01405,0,640,37269852.0,0,585,640,585,99811,3.005680736592159,37340425.40401358
